player_name,team,tackles,tackles_won,defensive_third_tackles,middle_third_tackles,attacking_third_tackles,dribblers_tackled,dribblers_challenged,dribblers_tackled_percent,challenges_lost,blocks,shots_blocked,passses_blocked,interceptions,tackles_and_interceptions,clearances,shot_leading_errors
David Raya,Arsenal,0,0,0,0,0,0,2,0.0,2,0,0,0,2,2,19,6
William Saliba,Arsenal,62,37,37,23,2,21,28,75.0,7,25,15,10,21,83,116,6
Declan Rice,Arsenal,52,24,21,25,6,16,37,43.2,21,24,11,13,25,77,44,0
Thomas Partey,Arsenal,84,51,24,38,22,44,72,61.1,28,26,7,19,34,118,47,4
Gabriel Magalhães,Arsenal,25,15,12,8,5,12,16,75.0,4,42,29,13,16,41,93,2
Leandro Trossard,Arsenal,28,19,5,14,9,10,32,31.3,22,32,0,32,9,37,17,0
Jurriën Timber,Arsenal,58,38,17,30,11,18,27,66.7,9,19,4,15,22,80,44,1
Martin Ødegaard,Arsenal,19,11,9,7,3,4,24,16.7,20,5,0,5,5,24,5,1
Gabriel Martinelli,Arsenal,20,15,8,5,7,7,23,30.4,16,12,0,12,4,24,17,0
Kai Havertz,Arsenal,16,9,3,6,7,4,15,26.7,11,22,4,18,6,22,31,1
Bukayo Saka,Arsenal,24,13,7,10,7,11,22,50.0,11,22,0,22,3,27,8,0
Mikel Merino,Arsenal,43,26,7,24,12,18,33,54.5,15,18,5,13,15,58,25,2
Myles Lewis-Skelly,Arsenal,22,14,10,9,3,10,10,100.0,0,2,1,1,6,28,23,0
Ben White,Arsenal,17,11,10,4,3,14,31,45.2,17,9,7,2,16,33,36,0
Riccardo Calafiori,Arsenal,26,18,15,9,2,18,29,62.1,11,12,6,6,9,35,25,0
Ethan Nwaneri,Arsenal,11,7,4,4,3,7,18,38.9,11,8,2,6,2,13,4,1
Jorginho,Arsenal,12,4,1,7,4,8,20,40.0,12,3,0,3,7,19,2,2
Jakub Kiwior,Arsenal,15,7,8,5,2,10,13,76.9,3,8,5,3,4,19,41,2
Gabriel Jesus,Arsenal,10,6,4,3,3,4,9,44.4,5,10,1,9,4,14,8,0
Raheem Sterling,Arsenal,8,4,1,2,5,4,8,50.0,4,3,0,3,1,9,3,0
Oleksandr Zinchenko,Arsenal,4,1,1,2,1,2,7,28.6,5,6,1,5,4,8,6,0
Kieran Tierney,Arsenal,6,5,4,1,1,4,6,66.7,2,0,0,0,2,8,5,0
Nathan Butler-Oyedeji,Arsenal,0,0,0,0,0,0,0,,0,0,0,0,0,0,0,0
Takehiro Tomiyasu,Arsenal,0,0,0,0,0,0,0,,0,0,0,0,0,0,1,0
Reiss Nelson,Arsenal,1,0,0,1,0,0,1,0.0,1,0,0,0,0,1,1,0
Squad Total,Arsenal,563,335,208,237,118,246,483,50.9,237,308,98,210,217,780,621,28
Opponent Total,Arsenal,660,399,383,204,73,302,604,50.0,302,385,164,221,249,909,975,36
Emiliano Martínez,Aston Villa,3,3,3,0,0,2,2,100.0,0,1,0,1,0,3,17,6
Youri Tielemans,Aston Villa,83,57,31,44,8,40,73,54.8,33,37,16,21,22,105,47,4
Morgan Rogers,Aston Villa,40,21,15,14,11,22,44,50.0,22,26,7,19,5,45,20,2
Ezri Konsa,Aston Villa,32,17,19,9,4,18,23,78.3,5,18,10,8,21,53,107,4
Ollie Watkins,Aston Villa,10,7,0,6,4,3,11,27.3,8,11,3,8,8,18,15,2
Lucas Digne,Aston Villa,65,38,40,16,9,44,66,66.7,22,23,4,19,25,90,89,1
John McGinn,Aston Villa,31,22,10,13,8,11,29,37.9,18,21,2,19,14,45,17,3
Matty Cash,Aston Villa,50,29,26,20,4,25,36,69.4,11,20,8,12,21,71,63,2
Pau Torres,Aston Villa,20,14,11,7,2,9,15,60.0,6,14,10,4,9,29,66,2
Jacob Ramsey,Aston Villa,30,15,14,10,6,10,20,50.0,10,23,4,19,8,38,8,1
Boubacar Kamara,Aston Villa,49,20,28,17,4,28,55,50.9,27,17,7,10,19,68,50,3
Amadou Onana,Aston Villa,49,24,22,23,4,14,27,51.9,13,15,7,8,25,74,41,3
Leon Bailey,Aston Villa,6,4,1,3,2,2,10,20.0,8,6,0,6,3,9,12,0
Tyrone Mings,Aston Villa,7,6,6,1,0,2,2,100.0,0,13,11,2,7,14,61,1
Ian Maatsen,Aston Villa,27,15,16,8,3,16,22,72.7,6,11,0,11,15,42,34,2
Diego Carlos,Aston Villa,8,3,6,1,1,4,6,66.7,2,13,7,6,5,13,36,2
Marco Asensio,Aston Villa,7,5,0,7,0,3,9,33.3,6,4,0,4,2,9,3,0
Axel Disasi,Aston Villa,8,5,7,1,0,3,7,42.9,4,4,1,3,5,13,18,0
Lamare Bogarde,Aston Villa,14,6,6,6,2,10,16,62.5,6,5,3,2,1,15,13,0
Andrés García,Aston Villa,9,5,5,3,1,4,8,50.0,4,2,0,2,2,11,10,2
Jáder Durán,Aston Villa,8,7,1,2,5,1,4,25.0,3,5,0,5,0,8,13,0
Marcus Rashford,Aston Villa,10,7,2,3,5,4,6,66.7,2,2,0,2,1,11,3,0
Ross Barkley,Aston Villa,14,3,4,10,0,9,14,64.3,5,9,3,6,10,24,5,0
Jaden Philogene Bidace,Aston Villa,11,5,4,7,0,4,6,66.7,2,5,0,5,3,14,2,1
Donyell Malen,Aston Villa,7,4,3,3,1,1,4,25.0,3,1,0,1,0,7,1,0
Robin Olsen,Aston Villa,1,0,1,0,0,1,1,100.0,0,0,0,0,0,1,2,1
Kosta Nedeljković,Aston Villa,7,5,1,3,3,2,3,66.7,1,1,0,1,0,7,3,0
Emi Buendía,Aston Villa,6,6,3,2,1,0,5,0.0,5,5,1,4,0,6,2,0
Squad Total,Aston Villa,612,353,285,239,88,292,524,55.7,232,312,104,208,231,843,758,42
Opponent Total,Aston Villa,656,368,306,250,100,288,593,48.6,305,398,129,269,327,983,811,28
Milos Kerkez,Bournemouth,52,26,25,20,7,24,38,63.2,14,36,11,25,44,96,103,3
Antoine Semenyo,Bournemouth,53,34,16,24,13,16,42,38.1,26,61,8,53,10,63,38,2
Illia Zabarnyi,Bournemouth,48,33,28,19,1,32,47,68.1,15,33,20,13,39,87,175,2
Lewis Cook,Bournemouth,81,42,41,36,4,37,67,55.2,30,30,11,19,40,121,68,0
Kepa Arrizabalaga,Bournemouth,1,0,1,0,0,0,2,0.0,2,1,0,1,0,1,15,3
Justin Kluivert,Bournemouth,21,9,4,10,7,4,21,19.0,17,24,0,24,13,34,23,1
Ryan Christie,Bournemouth,54,33,19,27,8,27,64,42.2,37,44,11,33,30,84,51,3
Evanilson,Bournemouth,16,10,6,5,5,8,12,66.7,4,11,2,9,0,16,21,0
Dean Huijsen,Bournemouth,36,26,19,16,1,18,28,64.3,10,36,28,8,50,86,185,4
Dango Ouattara,Bournemouth,35,26,14,11,10,17,41,41.5,24,36,10,26,11,46,51,0
Tyler Adams,Bournemouth,78,48,24,47,7,36,68,52.9,32,33,10,23,32,110,40,0
Marcus Tavernier,Bournemouth,42,24,14,19,9,10,26,38.5,16,16,3,13,5,47,11,0
Adam Smith,Bournemouth,22,10,11,5,6,12,25,48.0,13,12,5,7,14,36,48,1
Marcos Senesi,Bournemouth,36,21,23,11,2,14,30,46.7,16,15,7,8,11,47,56,0
David Brooks,Bournemouth,12,5,2,7,3,1,14,7.1,13,16,2,14,5,17,8,1
Alex Scott,Bournemouth,27,14,11,8,8,19,42,45.2,23,17,4,13,10,37,15,0
James Hill,Bournemouth,15,8,6,6,3,3,11,27.3,8,5,0,5,9,24,31,0
Julian Araujo,Bournemouth,8,3,4,4,0,5,12,41.7,7,3,0,3,6,14,16,0
Mark Travers,Bournemouth,0,0,0,0,0,0,0,,0,0,0,0,0,0,5,0
Enes Ünal,Bournemouth,1,0,0,0,1,0,3,0.0,3,1,0,1,0,1,6,0
Neto,Bournemouth,0,0,0,0,0,0,0,,0,0,0,0,0,0,1,1
Luis Sinisterra,Bournemouth,7,2,3,2,2,0,4,0.0,4,3,0,3,1,8,8,0
Philip Billing,Bournemouth,14,5,7,6,1,3,4,75.0,1,3,0,3,5,19,2,0
Max Aarons,Bournemouth,2,2,1,1,0,1,1,100.0,0,3,1,2,1,3,0,0
Daniel Jebbison,Bournemouth,3,2,2,1,0,3,5,60.0,2,2,1,1,1,4,1,0
Ben Winterburn,Bournemouth,0,0,0,0,0,0,1,0.0,1,0,0,0,2,2,0,0
Julio Soler,Bournemouth,1,1,1,0,0,1,1,100.0,0,1,0,1,0,1,0,0
Remy Rees-Dottin,Bournemouth,0,0,0,0,0,0,0,,0,0,0,0,0,0,0,0
Zain Silcott-Duberry,Bournemouth,1,1,0,0,1,1,1,100.0,0,0,0,0,0,1,0,0
Squad Total,Bournemouth,666,385,282,285,99,292,610,47.9,318,442,134,308,339,1005,978,21
Opponent Total,Bournemouth,624,381,308,249,67,288,568,50.7,280,391,152,239,266,890,963,46
Nathan Collins,Brentford,37,22,22,11,4,22,35,62.9,13,72,52,20,33,70,219,2
Bryan Mbeumo,Brentford,45,29,17,14,14,18,31,58.1,13,24,3,21,14,59,52,1
Mark Flekken,Brentford,4,4,4,0,0,3,9,33.3,6,2,0,2,0,4,26,4
Keane Lewis-Potter,Brentford,46,26,25,15,6,28,46,60.9,18,26,9,17,19,65,72,3
Mikkel Damsgaard,Brentford,80,43,27,27,26,30,77,39.0,47,39,2,37,26,106,30,2
Yoane Wissa,Brentford,22,12,6,8,8,11,27,40.7,16,29,8,21,8,30,20,3
Christian Nørgaard,Brentford,76,46,35,34,7,45,74,60.8,29,51,19,32,46,122,65,1
Sepp van den Berg,Brentford,37,22,23,10,4,18,27,66.7,9,51,37,14,20,57,124,3
Vitaly Janelt,Brentford,38,22,14,13,11,21,36,58.3,15,33,9,24,27,65,53,1
Kevin Schade,Brentford,36,23,14,10,12,12,20,60.0,8,17,2,15,5,41,32,0
Ethan Pinnock,Brentford,35,19,15,16,4,13,24,54.2,11,29,18,11,24,59,142,4
Kristoffer Ajer,Brentford,25,17,14,10,1,14,26,53.8,12,17,4,13,12,37,49,0
Yehor Yarmoliuk,Brentford,42,25,16,20,6,25,49,51.0,24,24,7,17,12,54,31,0
Mads Roerslev,Brentford,18,8,14,3,1,11,28,39.3,17,12,5,7,4,22,35,0
Mathias Jensen,Brentford,14,10,6,6,2,8,16,50.0,8,13,4,9,8,22,13,1
Michael Kayode,Brentford,15,10,11,4,0,9,11,81.8,2,2,0,2,5,20,15,0
Fabio Carvalho,Brentford,13,9,4,4,5,6,13,46.2,7,6,1,5,3,16,2,0
Ben Mee,Brentford,2,2,0,2,0,1,1,100.0,0,3,3,0,4,6,7,0
Thiago,Brentford,4,3,1,1,2,0,1,0.0,1,2,0,2,2,6,2,1
Hákon Rafn Valdimarsson,Brentford,0,0,0,0,0,0,0,,0,0,0,0,0,0,2,0
Edmond-Paris Maghoma,Brentford,2,1,0,2,0,1,3,33.3,2,2,2,0,1,3,2,0
Rico Henry,Brentford,0,0,0,0,0,0,4,0.0,4,3,1,2,1,1,2,0
Yunus Emre Konak,Brentford,4,4,0,4,0,1,2,50.0,1,2,0,2,0,4,0,0
Kim Jisoo,Brentford,0,0,0,0,0,0,0,,0,0,0,0,0,0,2,0
Frank Onyeka,Brentford,0,0,0,0,0,0,0,,0,0,0,0,0,0,0,0
Gustavo Nunes,Brentford,3,2,2,0,1,2,2,100.0,0,0,0,0,0,3,2,0
Jayden Meghoma,Brentford,0,0,0,0,0,0,0,,0,0,0,0,0,0,0,0
Ryan Trevitt,Brentford,1,1,1,0,0,0,0,,0,0,0,0,0,1,0,0
Squad Total,Brentford,599,360,271,214,114,299,562,53.2,263,459,186,273,274,873,999,26
Opponent Total,Brentford,549,333,252,202,95,270,524,51.5,254,347,103,244,276,825,975,28
Bart Verbruggen,Brighton,0,0,0,0,0,0,3,0.0,3,1,0,1,0,0,28,5
Jan Paul van Hecke,Brighton,41,27,21,19,1,21,39,53.8,18,33,19,14,23,64,138,2
Carlos Baleba,Brighton,73,42,25,33,15,46,76,60.5,30,44,10,34,43,116,42,1
Kaoru Mitoma,Brighton,44,26,15,13,16,19,48,39.6,29,48,3,45,13,57,10,0
Pervis Estupiñán,Brighton,60,40,31,22,7,32,47,68.1,15,17,3,14,36,96,63,2
Lewis Dunk,Brighton,17,10,8,7,2,11,19,57.9,8,28,18,10,13,30,79,2
Danny Welbeck,Brighton,24,15,6,13,5,7,19,36.8,12,18,3,15,5,29,14,0
João Pedro,Brighton,16,12,6,6,4,4,11,36.4,7,12,0,12,9,25,12,0
Jack Hinshelwood,Brighton,26,18,8,10,8,11,27,40.7,16,8,3,5,15,41,37,1
Yasin Ayari,Brighton,56,31,15,30,11,23,53,43.4,30,23,6,17,20,76,25,0
Joël Veltman,Brighton,42,28,23,16,3,30,51,58.8,21,22,7,15,18,60,66,0
Georginio Rutter,Brighton,39,15,13,18,8,14,36,38.9,22,20,3,17,10,49,13,2
Yankuba Minteh,Brighton,47,34,25,13,9,17,45,37.8,28,21,0,21,11,58,31,0
Matt O'Riley,Brighton,16,9,4,8,4,4,13,30.8,9,7,3,4,13,29,9,1
Simon Adingra,Brighton,23,14,10,8,5,10,24,41.7,14,12,0,12,8,31,6,2
Tariq Lamptey,Brighton,17,11,8,9,0,9,25,36.0,16,15,7,8,7,24,23,1
Igor,Brighton,4,4,2,1,1,4,10,40.0,6,23,14,9,4,8,39,1
Adam Webster,Brighton,9,6,5,3,1,5,12,41.7,7,12,9,3,18,27,33,1
Mats Wieffer,Brighton,46,27,20,22,4,26,38,68.4,12,15,1,14,14,60,24,3
Brajan Gruda,Brighton,14,6,6,5,3,7,14,50.0,7,8,0,8,2,16,5,1
Ferdi Kadioglu,Brighton,10,6,4,5,1,6,15,40.0,9,2,2,0,8,18,17,0
Diego Gómez,Brighton,17,10,8,7,2,9,19,47.4,10,12,0,12,7,24,10,1
James Milner,Brighton,5,2,1,3,1,3,3,100.0,0,4,2,2,2,7,2,1
Julio Enciso,Brighton,0,0,0,0,0,0,2,0.0,2,2,0,2,0,0,1,0
Evan Ferguson,Brighton,4,3,0,3,1,2,5,40.0,3,3,1,2,0,4,4,0
Jason Steele,Brighton,0,0,0,0,0,0,0,,0,0,0,0,0,0,1,0
Solly March,Brighton,6,3,2,2,2,5,8,62.5,3,3,0,3,2,8,2,1
Billy Gilmour,Brighton,3,3,2,1,0,3,4,75.0,1,1,0,1,0,3,1,0
Eiran Cashin,Brighton,0,0,0,0,0,0,1,0.0,1,0,0,0,0,0,2,0
Jakub Moder,Brighton,1,0,1,0,0,0,2,0.0,2,0,0,0,0,1,3,0
Jeremy Sarmiento,Brighton,0,0,0,0,0,0,0,,0,0,0,0,0,0,0,0
Squad Total,Brighton,660,402,269,277,114,328,669,49.0,341,414,114,300,301,961,740,28
Opponent Total,Brighton,704,399,357,266,81,372,692,53.8,320,387,136,251,301,1005,915,31
Moisés Caicedo,Chelsea,107,67,40,52,15,51,82,62.2,31,46,10,36,49,156,56,1
Cole Palmer,Chelsea,28,17,11,10,7,9,23,39.1,14,15,1,14,11,39,18,1
Levi Colwill,Chelsea,45,32,24,18,3,17,26,65.4,9,36,25,11,32,77,108,4
Marc Cucurella,Chelsea,61,39,30,26,5,27,54,50.0,27,46,15,31,25,86,86,3
Enzo Fernández,Chelsea,64,32,17,29,18,31,84,36.9,53,38,7,31,13,77,22,4
Robert Sánchez,Chelsea,0,0,0,0,0,0,1,0.0,1,0,0,0,2,2,22,9
Nicolas Jackson,Chelsea,22,13,6,7,9,5,10,50.0,5,15,2,13,3,25,15,0
Noni Madueke,Chelsea,22,15,7,12,3,13,36,36.1,23,17,0,17,8,30,11,0
Pedro Neto,Chelsea,22,9,9,9,4,8,19,42.1,11,14,2,12,9,31,6,0
Malo Gusto,Chelsea,44,28,27,15,2,25,48,52.1,23,29,8,21,24,68,48,5
Jadon Sancho,Chelsea,11,7,3,2,6,5,12,41.7,7,10,0,10,2,13,6,2
Wesley Fofana,Chelsea,13,12,6,7,0,6,14,42.9,8,14,9,5,14,27,55,2
Tosin Adarabioyo,Chelsea,14,10,10,4,0,8,12,66.7,4,9,7,2,10,24,62,0
Trevoh Chalobah,Chelsea,11,7,5,6,0,7,8,87.5,1,6,3,3,10,21,48,1
Roméo Lavia,Chelsea,22,13,5,13,4,10,21,47.6,11,6,0,6,16,38,10,1
Reece James,Chelsea,9,9,5,3,1,3,9,33.3,6,12,4,8,13,22,18,4
Christopher Nkunku,Chelsea,12,8,3,4,5,6,8,75.0,2,9,2,7,7,19,10,0
Filip Jørgensen,Chelsea,0,0,0,0,0,0,0,,0,0,0,0,0,0,0,3
Axel Disasi,Chelsea,7,4,5,1,1,6,11,54.5,5,4,1,3,2,9,11,1
João Félix,Chelsea,8,3,2,5,1,5,9,55.6,4,2,0,2,3,11,2,0
Benoît Badiashile,Chelsea,9,6,5,4,0,4,5,80.0,1,2,2,0,6,15,12,2
Kiernan Dewsbury-Hall,Chelsea,8,5,1,1,6,4,6,66.7,2,2,0,2,1,9,8,1
Joshua Acheampong,Chelsea,2,1,2,0,0,2,2,100.0,0,1,0,1,1,3,2,0
Renato Veiga,Chelsea,9,6,6,3,0,4,12,33.3,8,3,1,2,1,10,2,0
Mykhailo Mudryk,Chelsea,2,2,2,0,0,0,0,,0,3,1,2,0,2,1,0
Tyrique George,Chelsea,2,0,2,0,0,2,3,66.7,1,0,0,0,1,3,1,0
Marc Guiu,Chelsea,1,1,0,1,0,1,1,100.0,0,0,0,0,0,1,0,0
Mathis Amougou,Chelsea,0,0,0,0,0,0,0,,0,0,0,0,0,0,0,0
Shumaira Mheuka,Chelsea,0,0,0,0,0,0,0,,0,0,0,0,0,0,0,0
Squad Total,Chelsea,555,346,233,232,90,259,516,50.2,257,339,100,239,263,818,640,44
Opponent Total,Chelsea,596,346,299,229,68,314,629,49.9,315,409,166,243,279,875,845,40
Dean Henderson,Crystal Palace,2,1,2,0,0,2,6,33.3,4,0,0,0,0,2,22,0
Tyrick Mitchell,Crystal Palace,88,54,55,26,7,23,43,53.5,20,63,12,51,14,102,100,2
Daniel Muñoz,Crystal Palace,115,75,54,38,23,52,92,56.5,40,37,4,33,41,156,104,1
Marc Guéhi,Crystal Palace,61,34,36,23,2,31,47,66.0,16,55,23,32,28,89,162,2
Maxence Lacroix,Crystal Palace,67,40,51,15,1,32,47,68.1,15,44,19,25,52,119,191,2
Jean-Philippe Mateta,Crystal Palace,17,12,4,11,2,3,16,18.8,13,18,4,14,2,19,22,0
Eberechi Eze,Crystal Palace,39,22,14,16,9,17,36,47.2,19,27,0,27,11,50,9,3
Ismaila Sarr,Crystal Palace,21,10,9,9,3,7,23,30.4,16,25,8,17,9,30,37,0
Jefferson Lerma,Crystal Palace,32,16,13,15,4,19,35,54.3,16,35,16,19,37,69,65,1
Will Hughes,Crystal Palace,62,33,18,31,13,27,59,45.8,32,31,14,17,21,83,24,3
Chris Richards,Crystal Palace,44,28,21,17,6,23,39,59.0,16,37,13,24,19,63,101,0
Adam Wharton,Crystal Palace,34,14,14,16,4,17,44,38.6,27,11,2,9,20,54,27,0
Daichi Kamada,Crystal Palace,46,28,19,23,4,14,39,35.9,25,22,5,17,16,62,14,0
Trevoh Chalobah,Crystal Palace,20,16,7,12,1,12,23,52.2,11,19,9,10,19,39,57,3
Eddie Nketiah,Crystal Palace,14,7,6,4,4,6,12,50.0,6,10,1,9,2,16,11,0
Nathaniel Clyne,Crystal Palace,12,8,8,3,1,6,11,54.5,5,4,2,2,3,15,14,1
Cheick Doucouré,Crystal Palace,16,8,6,8,2,5,11,45.5,6,4,0,4,11,27,10,1
Justin Devenny,Crystal Palace,14,9,6,7,1,7,14,50.0,7,3,0,3,0,14,10,0
Odsonne Édouard,Crystal Palace,1,0,0,1,0,0,2,0.0,2,1,0,1,0,1,1,0
Joachim Andersen,Crystal Palace,1,1,1,0,0,1,2,50.0,1,0,0,0,0,1,7,0
Chadi Riad,Crystal Palace,5,2,2,2,1,2,3,66.7,1,0,0,0,2,7,0,0
Ben Chilwell,Crystal Palace,5,5,2,3,0,0,4,0.0,4,4,2,2,4,9,12,0
Jeffrey Schlupp,Crystal Palace,2,0,1,0,1,0,3,0.0,3,6,0,6,0,2,2,0
Romain Esse,Crystal Palace,2,2,2,0,0,2,2,100.0,0,1,0,1,1,3,0,0
Matheus França,Crystal Palace,1,0,0,1,0,0,0,,0,0,0,0,0,1,0,0
Jordan Ayew,Crystal Palace,1,0,0,0,1,0,0,,0,0,0,0,0,1,0,0
Caleb Kporha,Crystal Palace,2,1,2,0,0,2,2,100.0,0,0,0,0,0,2,1,0
Asher Agbinone,Crystal Palace,2,1,0,2,0,0,0,,0,0,0,0,0,2,0,0
Joel Ward,Crystal Palace,0,0,0,0,0,0,0,,0,0,0,0,0,0,0,0
Squad Total,Crystal Palace,726,427,353,283,90,310,615,50.4,305,457,134,323,312,1038,1003,19
Opponent Total,Crystal Palace,543,301,191,248,104,218,416,52.4,198,403,144,259,328,871,844,35
Jordan Pickford,Everton,1,0,1,0,0,1,2,50.0,1,0,0,0,1,2,29,2
James Tarkowski,Everton,64,40,39,22,3,24,39,61.5,15,57,42,15,41,105,213,4
Vitaliy Mykolenko,Everton,55,33,33,14,8,26,52,50.0,26,25,10,15,39,94,137,2
Idrissa Gana Gueye,Everton,125,74,57,52,16,54,91,59.3,37,48,9,39,44,169,33,1
Abdoulaye Doucouré,Everton,46,27,21,18,7,13,41,31.7,28,31,6,25,9,55,19,1
Jarrad Branthwaite,Everton,36,20,26,10,0,20,27,74.1,7,31,23,8,25,61,190,4
Iliman Ndiaye,Everton,48,25,18,15,15,19,45,42.2,26,28,5,23,17,65,24,1
Jack Harrison,Everton,32,22,12,12,8,15,43,34.9,28,18,2,16,9,41,32,2
Dominic Calvert-Lewin,Everton,9,7,1,4,4,2,6,33.3,4,6,2,4,6,15,19,0
Ashley Young,Everton,53,30,23,23,7,32,53,60.4,21,13,4,9,24,77,64,1
James Garner,Everton,42,28,24,16,2,20,36,55.6,16,19,4,15,20,62,36,0
Jake O'Brien,Everton,24,16,19,5,0,16,24,66.7,8,16,4,12,4,28,80,0
Jesper Lindstrøm,Everton,45,25,24,19,2,19,55,34.5,36,15,3,12,12,57,17,0
Dwight McNeil,Everton,12,7,5,5,2,9,20,45.0,11,7,0,7,5,17,2,1
Orel Mangala,Everton,16,8,3,11,2,5,8,62.5,3,8,3,5,21,37,24,1
Beto,Everton,14,6,2,8,4,5,8,62.5,3,10,1,9,3,17,21,1
Michael Keane,Everton,10,7,7,2,1,7,13,53.8,6,11,7,4,15,25,61,2
Carlos Alcaraz,Everton,11,5,5,3,3,3,9,33.3,6,7,1,6,4,15,10,0
Tim Iroegbunam,Everton,29,14,14,10,5,14,23,60.9,9,18,4,14,16,45,12,1
Armando Broja,Everton,3,1,1,1,1,0,0,,0,3,0,3,1,4,4,0
Nathan Patterson,Everton,11,6,7,4,0,7,14,50.0,7,2,0,2,2,13,7,0
Séamus Coleman,Everton,3,2,2,1,0,3,4,75.0,1,5,3,2,1,4,8,0
Roman Dixon,Everton,5,5,3,2,0,4,4,100.0,0,1,0,1,1,6,3,0
Harrison Armstrong,Everton,0,0,0,0,0,0,1,0.0,1,0,0,0,0,0,1,0
Youssef Chermiti,Everton,0,0,0,0,0,0,1,0.0,1,0,0,0,0,0,0,0
Mason Holgate,Everton,0,0,0,0,0,0,0,,0,0,0,0,0,0,0,0
Squad Total,Everton,694,408,347,257,90,318,619,51.4,301,379,133,246,320,1014,1046,24
Opponent Total,Everton,666,405,310,264,92,295,564,52.3,269,337,97,240,222,888,872,21
Bernd Leno,Fulham,2,2,2,0,0,2,2,100.0,0,1,0,1,0,2,10,5
Alex Iwobi,Fulham,42,24,13,21,8,21,32,65.6,11,25,1,24,13,55,28,0
Antonee Robinson,Fulham,90,57,53,30,7,44,89,49.4,45,37,7,30,57,147,124,2
Calvin Bassey,Fulham,53,33,34,19,0,21,30,70.0,9,39,17,22,19,72,111,8
Raúl Jiménez,Fulham,33,23,8,17,8,7,20,35.0,13,19,5,14,10,43,19,3
Joachim Andersen,Fulham,26,18,19,6,1,14,21,66.7,7,33,26,7,31,57,174,1
Saša Lukić,Fulham,66,37,21,39,6,21,53,39.6,32,19,7,12,26,92,32,0
Sander Berge,Fulham,48,28,22,22,4,25,37,67.6,12,26,8,18,21,69,36,1
Andreas Pereira,Fulham,23,13,7,11,5,10,41,24.4,31,16,2,14,8,31,17,3
Emile Smith Rowe,Fulham,31,18,7,14,10,8,24,33.3,16,21,2,19,11,42,16,0
Kenny Tete,Fulham,50,34,24,14,12,20,34,58.8,14,25,8,17,29,79,53,0
Timothy Castagne,Fulham,46,29,28,15,3,26,45,57.8,19,15,6,9,22,68,83,0
Adama Traoré,Fulham,17,12,8,4,5,5,13,38.5,8,7,0,7,1,18,6,3
Issa Diop,Fulham,26,12,18,8,0,13,18,72.2,5,10,7,3,9,35,72,2
Harry Wilson,Fulham,16,11,10,3,3,9,15,60.0,6,13,1,12,5,21,7,1
Rodrigo Muniz,Fulham,10,5,3,5,2,4,4,100.0,0,9,2,7,5,15,14,0
Ryan Sessegnon,Fulham,27,13,11,11,5,9,19,47.4,10,13,1,12,3,30,17,0
Reiss Nelson,Fulham,8,6,3,3,2,5,13,38.5,8,11,0,11,5,13,2,0
Jorge Cuenca,Fulham,2,2,2,0,0,2,5,40.0,3,3,3,0,2,4,21,0
Tom Cairney,Fulham,11,5,4,2,5,4,7,57.1,3,5,1,4,4,15,1,1
Willian,Fulham,4,2,0,3,1,2,6,33.3,4,0,0,0,1,5,1,0
Joshua King,Fulham,5,3,2,3,0,0,2,0.0,2,2,0,2,1,6,1,0
Harrison Reed,Fulham,6,3,3,2,1,1,3,33.3,2,1,0,1,1,7,3,0
Martial Godo,Fulham,0,0,0,0,0,0,0,,0,1,0,1,1,1,0,0
Carlos Vinícius,Fulham,0,0,0,0,0,0,1,0.0,1,1,0,1,0,0,0,0
Jay Stansfield,Fulham,0,0,0,0,0,0,0,,0,0,0,0,0,0,0,0
Squad Total,Fulham,642,390,302,252,88,273,534,51.1,261,352,104,248,285,927,848,30
Opponent Total,Fulham,510,290,226,216,68,247,523,47.2,276,406,136,270,318,828,965,25
Dara O'Shea,Ipswich Town,47,30,33,11,3,20,31,64.5,11,61,49,12,31,78,211,4
Liam Delap,Ipswich Town,11,8,3,3,5,2,14,14.3,12,8,0,8,2,13,28,0
Leif Davis,Ipswich Town,45,26,32,9,4,29,46,63.0,17,24,8,16,25,70,72,3
Sam Morsy,Ipswich Town,65,38,38,23,4,26,58,44.8,32,32,13,19,29,94,44,4
Omari Hutchinson,Ipswich Town,31,12,14,10,7,13,47,27.7,34,25,1,24,10,41,13,1
Jacob Greaves,Ipswich Town,38,20,20,17,1,21,33,63.6,12,38,25,13,19,57,133,3
Jens Cajuste,Ipswich Town,42,20,19,22,1,21,49,42.9,28,24,9,15,25,67,33,2
Arijanet Muric,Ipswich Town,0,0,0,0,0,0,2,0.0,2,0,0,0,0,0,10,5
Axel Tuanzebe,Ipswich Town,29,17,20,3,6,16,24,66.7,8,18,9,9,22,51,54,1
Cameron Burgess,Ipswich Town,17,12,14,3,0,9,11,81.8,2,20,15,5,14,31,128,3
Ben Johnson,Ipswich Town,38,22,23,12,3,20,41,48.8,21,22,5,17,13,51,54,1
Kalvin Phillips,Ipswich Town,35,19,8,20,7,15,39,38.5,24,35,6,29,19,54,37,2
Sammie Szmodics,Ipswich Town,15,9,4,9,2,6,23,26.1,17,10,2,8,6,21,14,0
Luke Woolfenden,Ipswich Town,9,6,5,4,0,2,5,40.0,3,21,14,7,19,28,76,0
Alex Palmer,Ipswich Town,0,0,0,0,0,0,0,,0,0,0,0,0,0,12,0
Wes Burns,Ipswich Town,13,11,1,9,3,4,10,40.0,6,7,2,5,10,23,13,2
Jack Clarke,Ipswich Town,28,17,11,9,8,16,32,50.0,16,6,0,6,7,35,29,1
Julio Enciso,Ipswich Town,12,9,3,6,3,4,11,36.4,7,5,1,4,1,13,6,0
Conor Chaplin,Ipswich Town,12,5,4,6,2,6,13,46.2,7,8,1,7,3,15,3,0
Nathan Broadhead,Ipswich Town,7,3,2,5,0,3,9,33.3,6,6,1,5,4,11,5,0
Christian Walton,Ipswich Town,0,0,0,0,0,0,1,0.0,1,0,0,0,0,0,1,1
Jaden Philogene Bidace,Ipswich Town,14,7,6,6,2,8,15,53.3,7,11,1,10,10,24,9,1
Jack Taylor,Ipswich Town,20,10,6,11,3,12,25,48.0,13,10,3,7,9,29,24,0
Harry Clarke,Ipswich Town,5,3,3,2,0,3,6,50.0,3,5,4,1,4,9,14,3
George Hirst,Ipswich Town,3,3,1,0,2,1,3,33.3,2,1,1,0,2,5,10,0
Conor Townsend,Ipswich Town,11,8,9,2,0,8,11,72.7,3,8,6,2,4,15,16,0
Chiedozie Ogbene,Ipswich Town,7,3,1,2,4,2,4,50.0,2,1,0,1,1,8,3,0
Massimo Luongo,Ipswich Town,8,5,6,1,1,4,7,57.1,3,4,2,2,2,10,2,0
Ben Godfrey,Ipswich Town,1,0,1,0,0,1,1,100.0,0,1,1,0,2,3,3,0
Ali Al Hamadi,Ipswich Town,1,0,0,0,1,0,2,0.0,2,0,0,0,0,1,2,0
Marcus Harness,Ipswich Town,1,0,0,0,1,0,3,0.0,3,2,1,1,0,1,1,0
George Edmundson,Ipswich Town,0,0,0,0,0,0,0,,0,0,0,0,0,0,0,0
Squad Total,Ipswich Town,565,323,287,205,73,272,576,47.2,304,413,180,233,293,858,1060,37
Opponent Total,Ipswich Town,587,337,252,237,98,265,524,50.6,259,344,96,248,224,811,694,21
Jamie Vardy,Leicester City,19,13,7,7,5,4,13,30.8,9,8,4,4,5,24,23,0
James Justin,Leicester City,50,30,25,20,5,28,51,54.9,23,43,14,29,45,95,132,3
Wout Faes,Leicester City,39,23,25,12,2,23,43,53.5,20,45,33,12,26,65,173,4
Victor Bernth Kristiansen,Leicester City,85,50,54,26,5,47,87,54.0,40,37,14,23,40,125,72,3
Mads Hermansen,Leicester City,1,1,1,0,0,1,1,100.0,0,1,0,1,0,1,13,4
Wilfred Ndidi,Leicester City,81,50,45,29,7,27,54,50.0,27,47,19,28,29,110,78,0
Bilal El Khannouss,Leicester City,47,27,15,27,5,15,29,51.7,14,22,4,18,6,53,10,3
Boubakary Soumaré,Leicester City,33,18,21,11,1,18,30,60.0,12,22,10,12,25,58,31,3
Harry Winks,Leicester City,24,11,12,10,2,13,30,43.3,17,19,7,12,9,33,20,0
Conor Coady,Leicester City,12,8,6,5,1,3,6,50.0,3,28,20,8,13,25,67,2
Jordan Ayew,Leicester City,26,14,7,14,5,6,19,31.6,13,19,1,18,12,38,17,0
Stephy Mavididi,Leicester City,34,19,16,10,8,14,42,33.3,28,26,2,24,11,45,15,0
Jannik Vestergaard,Leicester City,22,10,16,6,0,9,15,60.0,6,21,14,7,16,38,74,1
Facundo Buonanotte,Leicester City,53,32,17,22,14,21,67,31.3,46,33,6,27,12,65,14,0
Caleb Okoli,Leicester City,25,14,8,15,2,11,18,61.1,7,24,14,10,15,40,79,3
Luke Thomas,Leicester City,27,21,21,4,2,19,35,54.3,16,13,5,8,18,45,41,1
Oliver Skipp,Leicester City,20,4,5,12,3,9,15,60.0,6,19,6,13,10,30,11,2
Bobby De Cordova-Reid,Leicester City,9,4,3,6,0,4,14,28.6,10,6,1,5,0,9,10,0
Jakub Stolarczyk,Leicester City,2,1,2,0,0,1,2,50.0,1,0,0,0,0,2,6,0
Kasey McAteer,Leicester City,18,14,10,5,3,10,23,43.5,13,15,1,14,3,21,15,0
Abdul Fatawu Issahaku,Leicester City,21,15,13,2,6,11,19,57.9,8,7,0,7,4,25,12,0
Patson Daka,Leicester City,17,9,4,9,4,7,17,41.2,10,7,1,6,1,18,10,0
Ricardo Pereira,Leicester City,11,6,4,4,3,6,12,50.0,6,6,2,4,2,13,10,0
Danny Ward,Leicester City,0,0,0,0,0,0,0,,0,0,0,0,0,0,1,0
Hamza Choudhury,Leicester City,1,1,1,0,0,1,3,33.3,2,4,2,2,5,6,2,0
Woyo Coulibaly,Leicester City,6,4,4,2,0,2,2,100.0,0,3,1,2,5,11,1,0
Jeremy Monga,Leicester City,1,1,0,1,0,1,1,100.0,0,3,2,1,0,1,1,0
Odsonne Édouard,Leicester City,1,1,1,0,0,0,0,,0,0,0,0,0,1,1,0
Jake Evans,Leicester City,0,0,0,0,0,0,1,0.0,1,0,0,0,0,0,1,0
Will Alves,Leicester City,0,0,0,0,0,0,0,,0,0,0,0,0,0,0,0
Michael Golding,Leicester City,0,0,0,0,0,0,0,,0,0,0,0,0,0,0,0
Squad Total,Leicester City,685,401,343,259,83,311,649,47.9,338,478,183,295,312,997,940,29
Opponent Total,Leicester City,612,392,216,275,121,294,547,53.7,253,339,93,246,259,871,780,22
Virgil van Dijk,Liverpool,35,17,17,16,2,11,20,55.0,9,27,16,11,54,89,184,4
Mohamed Salah,Liverpool,21,11,7,5,9,8,17,47.1,9,11,0,11,7,28,5,0
Ryan Gravenberch,Liverpool,67,35,27,29,11,32,54,59.3,22,35,10,25,57,124,57,2
Alexis Mac Allister,Liverpool,95,58,28,51,16,55,104,52.9,49,61,6,55,22,117,29,1
Ibrahima Konaté,Liverpool,38,26,25,11,2,24,34,70.6,10,28,15,13,12,50,128,2
Andrew Robertson,Liverpool,39,22,25,10,4,31,50,62.0,19,10,4,6,21,60,53,2
Trent Alexander-Arnold,Liverpool,71,50,43,19,9,48,103,46.6,55,26,9,17,31,102,54,4
Dominik Szoboszlai,Liverpool,33,20,12,16,5,15,39,38.5,24,37,4,33,9,42,19,2
Luis Díaz,Liverpool,35,23,11,18,6,13,37,35.1,24,19,0,19,7,42,7,1
Alisson,Liverpool,1,0,1,0,0,0,1,0.0,1,0,0,0,0,1,13,1
Cody Gakpo,Liverpool,27,15,5,13,9,12,24,50.0,12,21,2,19,11,38,16,1
Curtis Jones,Liverpool,37,21,6,22,9,17,26,65.4,9,19,9,10,7,44,8,3
Diogo Jota,Liverpool,14,8,2,8,4,7,19,36.8,12,9,0,9,7,21,6,0
Caoimhín Kelleher,Liverpool,0,0,0,0,0,0,0,,0,0,0,0,0,0,1,2
Darwin Núñez,Liverpool,20,17,11,3,6,6,16,37.5,10,6,0,6,3,23,12,0
Kostas Tsimikas,Liverpool,29,18,13,11,5,13,20,65.0,7,5,2,3,10,39,20,0
Joe Gomez,Liverpool,13,10,5,7,1,11,16,68.8,5,9,6,3,7,20,20,2
Conor Bradley,Liverpool,13,10,7,4,2,10,20,50.0,10,5,0,5,4,17,25,0
Jarell Quansah,Liverpool,11,8,8,3,0,6,8,75.0,2,8,7,1,6,17,18,1
Harvey Elliott,Liverpool,4,3,2,1,1,1,5,20.0,4,5,1,4,1,5,2,1
Wataru Endo,Liverpool,11,8,6,5,0,6,10,60.0,4,7,1,6,3,14,7,0
Federico Chiesa,Liverpool,0,0,0,0,0,0,2,0.0,2,1,0,1,0,0,0,1
Vitezslav Jaros,Liverpool,0,0,0,0,0,0,0,,0,0,0,0,0,0,0,0
Jayden Danns,Liverpool,0,0,0,0,0,0,1,0.0,1,0,0,0,0,0,0,0
Squad Total,Liverpool,614,380,261,252,101,326,626,52.1,300,349,92,257,279,893,684,30
Opponent Total,Liverpool,615,379,332,214,69,287,574,50.0,287,437,172,265,298,913,1028,41
Joško Gvardiol,Manchester City,54,36,24,19,11,20,38,52.6,18,41,20,21,39,93,117,8
Erling Haaland,Manchester City,10,5,3,3,4,2,6,33.3,4,11,1,10,5,15,23,0
Bernardo Silva,Manchester City,53,35,15,29,9,24,52,46.2,28,33,7,26,20,73,29,3
Ederson,Manchester City,0,0,0,0,0,0,2,0.0,2,0,0,0,1,1,9,2
Mateo Kovačić,Manchester City,68,38,22,38,8,31,65,47.7,34,20,0,20,22,90,20,1
Rúben Dias,Manchester City,16,10,6,9,1,7,11,63.6,4,19,16,3,18,34,61,3
İlkay Gündoğan,Manchester City,24,13,4,15,5,10,23,43.5,13,14,0,14,13,37,22,0
Rico Lewis,Manchester City,30,19,13,12,5,13,21,61.9,8,28,7,21,13,43,45,1
Manuel Akanji,Manchester City,17,11,10,4,3,9,15,60.0,6,11,8,3,7,24,61,3
Sávio,Manchester City,23,17,5,10,8,10,19,52.6,9,14,2,12,6,29,9,1
Phil Foden,Manchester City,12,5,5,4,3,7,18,38.9,11,13,1,12,9,21,7,1
Kevin De Bruyne,Manchester City,17,9,7,5,5,5,23,21.7,18,8,0,8,7,24,10,1
Matheus Nunes,Manchester City,32,21,13,13,6,15,34,44.1,19,14,3,11,13,45,35,1
Jeremy Doku,Manchester City,30,21,9,12,9,8,15,53.3,7,10,1,9,4,34,2,0
Stefan Ortega,Manchester City,0,0,0,0,0,0,1,0.0,1,0,0,0,0,0,11,1
Omar Marmoush,Manchester City,11,6,2,7,2,7,15,46.7,8,15,1,14,5,16,3,0
Kyle Walker,Manchester City,17,10,7,7,3,14,26,53.8,12,13,4,9,3,20,13,1
Nathan Aké,Manchester City,9,7,7,2,0,4,6,66.7,2,7,2,5,3,12,22,1
Nicolás González,Manchester City,15,6,5,6,4,6,11,54.5,5,9,0,9,5,20,17,0
Jack Grealish,Manchester City,9,5,4,2,3,2,5,40.0,3,12,2,10,2,11,5,1
John Stones,Manchester City,6,2,3,2,1,5,5,100.0,0,5,3,2,4,10,19,1
Nico O’Reilly,Manchester City,9,4,3,3,3,4,8,50.0,4,5,1,4,4,13,12,0
Abdukodir Khusanov,Manchester City,5,4,4,1,0,2,3,66.7,1,5,4,1,3,8,29,1
James Mcatee,Manchester City,5,2,0,4,1,1,7,14.3,6,8,0,8,2,7,1,0
Jahmai Simpson-Pusey,Manchester City,1,0,1,0,0,0,1,0.0,1,1,1,0,0,1,2,0
Rodri,Manchester City,2,1,1,1,0,0,0,,0,1,0,1,1,3,0,0
Divin Mubama,Manchester City,0,0,0,0,0,0,0,,0,0,0,0,0,0,0,0
Oscar Bobb,Manchester City,0,0,0,0,0,0,0,,0,0,0,0,0,0,0,0
Vitor Reis,Manchester City,0,0,0,0,0,0,0,,0,0,0,0,0,0,1,0
Squad Total,Manchester City,475,287,173,208,94,206,430,47.9,224,317,84,233,209,684,585,31
Opponent Total,Manchester City,668,386,400,208,60,290,657,44.1,367,434,163,271,294,962,903,32
André Onana,Manchester United,1,1,1,0,0,1,3,33.3,2,0,0,0,0,1,11,4
Bruno Fernandes,Manchester United,77,47,25,37,15,30,78,38.5,48,33,5,28,25,102,35,2
Noussair Mazraoui,Manchester United,109,63,55,40,14,55,89,61.8,34,33,8,25,34,143,91,1
Diogo Dalot,Manchester United,67,39,39,22,6,34,52,65.4,18,22,9,13,37,104,72,0
Matthijs de Ligt,Manchester United,30,22,17,12,1,23,32,71.9,9,29,21,8,33,63,96,0
Alejandro Garnacho,Manchester United,29,18,10,6,13,12,36,33.3,24,19,0,19,13,42,11,2
Manuel Ugarte Ribeiro,Manchester United,75,47,32,34,9,29,67,43.3,38,32,4,28,27,102,17,2
Rasmus Højlund,Manchester United,3,1,0,2,1,0,4,0.0,4,5,0,5,1,4,6,0
Lisandro Martínez,Manchester United,40,24,25,12,3,21,36,58.3,15,22,8,14,32,72,57,1
Kobbie Mainoo,Manchester United,44,27,17,14,13,23,38,60.5,15,16,2,14,19,63,13,1
Amad Diallo,Manchester United,36,29,7,20,9,18,30,60.0,12,12,0,12,11,47,17,0
Harry Maguire,Manchester United,27,14,21,5,1,14,20,70.0,6,15,12,3,39,66,73,1
Casemiro,Manchester United,77,46,45,23,9,41,66,62.1,25,33,10,23,12,89,48,3
Joshua Zirkzee,Manchester United,14,8,3,8,3,5,10,50.0,5,15,4,11,6,20,8,1
Leny Yoro,Manchester United,29,11,19,9,1,13,19,68.4,6,5,3,2,18,47,43,0
Marcus Rashford,Manchester United,7,4,2,2,3,3,9,33.3,6,8,0,8,4,11,7,0
Christian Eriksen,Manchester United,19,9,4,12,3,11,26,42.3,15,14,4,10,7,26,7,0
Patrick Dorgu,Manchester United,25,19,12,11,2,14,19,73.7,5,10,0,10,4,29,19,2
Mason Mount,Manchester United,12,4,5,7,0,8,10,80.0,2,9,1,8,3,15,3,0
Victor Lindelöf,Manchester United,6,2,5,0,1,3,4,75.0,1,5,3,2,7,13,33,2
Harry Amass,Manchester United,6,2,5,1,0,2,8,25.0,6,11,1,10,2,8,11,0
Jonny Evans,Manchester United,7,5,4,3,0,2,4,50.0,2,2,1,1,4,11,13,0
Altay Bayındır,Manchester United,0,0,0,0,0,0,1,0.0,1,0,0,0,0,0,6,1
Luke Shaw,Manchester United,4,3,2,2,0,2,2,100.0,0,5,1,4,2,6,7,0
Tyler Fredricson,Manchester United,5,3,3,2,0,1,2,50.0,1,2,0,2,1,6,11,0
Tyrell Malacia,Manchester United,2,1,2,0,0,1,2,50.0,1,0,0,0,1,3,1,1
Chidozie Obi-Martin,Manchester United,2,1,0,0,2,2,2,100.0,0,0,0,0,0,2,1,0
Ayden Heaven,Manchester United,3,3,1,2,0,2,2,100.0,0,2,2,0,1,4,6,0
Toby Collyer,Manchester United,12,9,6,6,0,5,6,83.3,1,2,1,1,2,14,3,0
Antony,Manchester United,6,3,4,2,0,2,5,40.0,3,2,0,2,2,8,0,0
Scott McTominay,Manchester United,0,0,0,0,0,0,1,0.0,1,0,0,0,0,0,1,0
Squad Total,Manchester United,774,465,371,294,109,377,683,55.2,306,363,100,263,347,1121,727,24
Opponent Total,Manchester United,649,394,308,249,92,310,558,55.6,248,457,162,295,314,963,820,19
Bruno Guimarães,Newcastle United,76,43,37,28,11,32,67,47.8,35,35,10,25,28,104,42,4
Dan Burn,Newcastle United,35,20,20,13,2,17,33,51.5,16,34,24,10,26,61,184,3
Alexander Isak,Newcastle United,12,5,2,3,7,5,15,33.3,10,18,2,16,3,15,17,1
Fabian Schär,Newcastle United,34,21,15,17,2,14,34,41.2,20,37,24,13,41,75,125,3
Valentino Livramento,Newcastle United,54,36,35,15,4,32,59,54.2,27,35,10,25,21,75,103,1
Joelinton,Newcastle United,57,35,23,23,11,25,44,56.8,19,37,7,30,23,80,47,2
Jacob Murphy,Newcastle United,24,16,8,10,6,18,35,51.4,17,31,0,31,12,36,31,1
Sandro Tonali,Newcastle United,48,30,21,22,5,23,46,50.0,23,32,10,22,33,81,33,2
Nick Pope,Newcastle United,0,0,0,0,0,0,0,,0,1,0,1,1,1,30,5
Anthony Gordon,Newcastle United,31,17,9,18,4,12,34,35.3,22,24,2,22,6,37,9,2
Lewis Hall,Newcastle United,58,41,28,22,8,40,74,54.1,34,33,18,15,18,76,75,3
Harvey Barnes,Newcastle United,16,9,4,6,6,3,11,27.3,8,7,1,6,6,22,14,1
Kieran Trippier,Newcastle United,37,20,18,13,6,21,35,60.0,14,11,3,8,12,49,49,0
Joe Willock,Newcastle United,28,16,15,10,3,18,29,62.1,11,24,6,18,6,34,7,0
Martin Dúbravka,Newcastle United,0,0,0,0,0,0,0,,0,0,0,0,0,0,3,0
Sean Longstaff,Newcastle United,27,16,10,9,8,18,27,66.7,9,17,5,12,7,34,8,0
Lloyd Kelly,Newcastle United,5,4,4,1,0,1,1,100.0,0,6,4,2,1,6,17,0
Sven Botman,Newcastle United,8,6,4,4,0,4,6,66.7,2,4,3,1,5,13,19,0
Emil Krafth,Newcastle United,4,2,2,1,1,2,3,66.7,1,5,4,1,2,6,14,0
Callum Wilson,Newcastle United,2,2,0,1,1,0,2,0.0,2,2,0,2,1,3,1,0
Lewis Miley,Newcastle United,12,10,4,7,1,7,14,50.0,7,5,1,4,2,14,5,2
Miguel Almirón,Newcastle United,3,2,2,0,1,2,3,66.7,1,2,0,2,0,3,0,0
William Osula,Newcastle United,1,0,0,0,1,0,2,0.0,2,0,0,0,4,5,2,0
Matt Targett,Newcastle United,0,0,0,0,0,0,1,0.0,1,0,0,0,1,1,1,0
Squad Total,Newcastle United,572,351,261,223,88,294,575,51.1,281,400,134,266,259,831,836,30
Opponent Total,Newcastle United,706,416,310,289,107,284,557,51.0,273,445,141,304,281,987,836,40
Matz Sels,Nottingham Forest,1,1,1,0,0,1,1,100.0,0,0,0,0,0,1,25,1
Nikola Milenković,Nottingham Forest,44,27,31,11,2,22,28,78.6,6,40,24,16,25,69,196,1
Murillo,Nottingham Forest,53,36,38,12,3,27,46,58.7,19,67,44,23,32,85,236,3
Ola Aina,Nottingham Forest,54,41,39,14,1,35,63,55.6,28,32,12,20,31,85,107,4
Chris Wood,Nottingham Forest,5,4,1,2,2,2,9,22.2,7,12,7,5,5,10,27,1
Morgan Gibbs-White,Nottingham Forest,42,21,14,22,6,16,32,50.0,16,17,4,13,21,63,28,1
Elliot Anderson,Nottingham Forest,86,52,51,28,7,44,103,42.7,59,44,9,35,30,116,70,4
Anthony Elanga,Nottingham Forest,18,13,8,8,2,5,17,29.4,12,11,1,10,6,24,25,0
Neco Williams,Nottingham Forest,79,48,57,16,6,45,75,60.0,30,40,9,31,25,104,129,2
Callum Hudson-Odoi,Nottingham Forest,20,14,7,8,5,11,17,64.7,6,11,0,11,13,33,11,1
Nicolás Domínguez,Nottingham Forest,78,40,35,32,11,30,67,44.8,37,37,11,26,29,107,49,1
Ryan Yates,Nottingham Forest,42,21,24,14,4,17,37,45.9,20,36,9,27,26,68,61,1
Álex Moreno,Nottingham Forest,25,18,20,5,0,15,39,38.5,24,11,5,6,15,40,43,0
Morato,Nottingham Forest,21,13,18,2,1,13,21,61.9,8,12,4,8,10,31,77,2
Jota Silva,Nottingham Forest,25,13,12,11,2,5,25,20.0,20,9,1,8,12,37,17,0
Ibrahim Sangaré,Nottingham Forest,24,13,6,15,3,6,14,42.9,8,8,3,5,4,28,7,1
James Ward-Prowse,Nottingham Forest,4,1,1,3,0,2,2,100.0,0,3,2,1,5,9,8,0
Danilo,Nottingham Forest,6,3,5,1,0,2,4,50.0,2,2,1,1,3,9,3,0
Taiwo Awoniyi,Nottingham Forest,6,3,0,3,3,4,5,80.0,1,1,0,1,0,6,7,0
Ramón Sosa,Nottingham Forest,5,3,3,0,2,1,5,20.0,4,9,0,9,4,9,5,0
Willy Boly,Nottingham Forest,6,1,5,1,0,4,4,100.0,0,4,2,2,3,9,12,0
Harry Toffolo,Nottingham Forest,5,3,3,1,1,3,4,75.0,1,2,2,0,2,7,12,0
Eric da Silva Moreira,Nottingham Forest,2,2,2,0,0,2,6,33.3,4,0,0,0,1,3,0,0
Squad Total,Nottingham Forest,651,391,381,209,61,312,624,50.0,312,408,150,258,302,953,1155,23
Opponent Total,Nottingham Forest,523,341,238,197,88,220,475,46.3,255,343,116,227,254,777,827,35
Kyle Walker-Peters,Southampton,44,29,22,15,7,16,35,45.7,19,27,15,12,19,63,90,1
Mateus Fernandes,Southampton,86,46,43,28,15,33,66,50.0,33,41,7,34,26,112,34,7
Taylor Harwood-Bellis,Southampton,27,19,13,11,3,19,35,54.3,16,62,40,22,30,57,137,6
Jan Bednarek,Southampton,36,19,23,13,0,16,31,51.6,15,47,36,11,56,92,190,5
Aaron Ramsdale,Southampton,0,0,0,0,0,0,2,0.0,2,0,0,0,2,2,9,2
Flynn Downes,Southampton,46,24,21,20,5,15,35,42.9,20,24,6,18,31,77,46,4
Joe Aribo,Southampton,47,33,17,24,6,17,35,48.6,18,26,10,16,20,67,32,3
Tyler Dibling,Southampton,34,20,13,18,3,16,26,61.5,10,19,5,14,8,42,16,1
Ryan Manning,Southampton,28,17,16,10,2,14,26,53.8,12,20,11,9,17,45,47,0
Lesley Ugochukwu,Southampton,49,24,15,30,4,18,35,51.4,17,27,10,17,14,63,21,1
Jack Stephens,Southampton,32,19,23,9,0,15,27,55.6,12,20,13,7,11,43,49,2
Yukinari Sugawara,Southampton,29,16,14,14,1,18,30,60.0,12,17,7,10,10,39,46,3
Kamaldeen Sulemana,Southampton,17,15,6,4,7,8,13,61.5,5,12,3,9,6,23,9,0
Adam Armstrong,Southampton,12,3,2,7,3,3,14,21.4,11,6,1,5,3,15,8,0
Cameron Archer,Southampton,11,7,6,3,2,2,9,22.2,7,5,1,4,2,13,10,0
James Bree,Southampton,18,13,8,9,1,10,25,40.0,15,9,3,6,8,26,28,0
Paul Onuachu,Southampton,7,2,1,5,1,3,7,42.9,4,7,2,5,1,8,16,1
Nathan Wood-Gordon,Southampton,10,7,6,3,1,5,8,62.5,3,8,5,3,4,14,26,2
William Smallbone,Southampton,18,11,8,8,2,7,21,33.3,14,8,0,8,2,20,12,2
Alex McCarthy,Southampton,0,0,0,0,0,0,0,,0,0,0,0,0,0,1,4
Adam Lallana,Southampton,8,5,4,4,0,2,12,16.7,10,4,1,3,5,13,5,0
Ben Brereton,Southampton,3,2,0,2,1,1,9,11.1,8,2,1,1,0,3,4,0
Ryan Fraser,Southampton,6,2,2,4,0,4,6,66.7,2,1,1,0,1,7,9,0
Welington,Southampton,16,5,12,3,1,10,15,66.7,5,3,1,2,6,22,21,0
Ross Stewart,Southampton,3,2,1,0,2,2,6,33.3,4,3,0,3,0,3,6,0
Joe Lumley,Southampton,0,0,0,0,0,0,0,,0,0,0,0,0,0,3,3
Armel Bella Kotchap,Southampton,7,5,5,2,0,3,6,50.0,3,2,2,0,5,12,21,1
Charlie Taylor,Southampton,7,5,4,3,0,5,6,83.3,1,5,3,2,3,10,22,1
Albert Grønbaek,Southampton,4,1,1,1,2,3,10,30.0,7,1,1,0,0,4,1,0
Maxwel Cornet,Southampton,5,5,1,4,0,0,4,0.0,4,0,0,0,0,5,2,0
Samuel Edozie,Southampton,3,1,0,1,2,2,2,100.0,0,0,0,0,0,3,0,0
Jay Robinson,Southampton,2,1,2,0,0,0,0,,0,0,0,0,0,2,0,0
Samuel Amo-Ameyaw,Southampton,1,0,0,1,0,1,1,100.0,0,0,0,0,0,1,0,0
Ronnie Edwards,Southampton,0,0,0,0,0,0,0,,0,1,1,0,0,0,0,0
Carlos Alcaraz,Southampton,0,0,0,0,0,0,0,,0,0,0,0,1,1,0,0
Squad Total,Southampton,616,358,289,256,71,268,557,48.1,289,407,186,221,291,907,921,49
Opponent Total,Southampton,645,384,243,279,123,313,599,52.3,286,343,120,223,298,943,709,9
Pedro Porro,Tottenham,63,46,31,22,10,42,73,57.5,31,44,17,27,34,97,82,1
Dejan Kulusevski,Tottenham,45,23,17,13,15,19,51,37.3,32,34,5,29,13,58,10,1
Dominic Solanke,Tottenham,18,11,1,12,5,4,14,28.6,10,18,7,11,0,18,22,0
Brennan Johnson,Tottenham,39,26,9,20,10,16,31,51.6,15,25,3,22,4,43,11,0
Guglielmo Vicario,Tottenham,0,0,0,0,0,0,0,,0,0,0,0,1,1,14,6
Son Heung-min,Tottenham,17,9,3,8,6,5,23,21.7,18,10,0,10,5,22,16,1
Destiny Udogie,Tottenham,74,47,41,26,7,33,47,70.2,14,40,6,34,21,95,35,1
James Maddison,Tottenham,31,19,8,16,7,9,29,31.0,20,15,4,11,12,43,19,1
Pape Matar Sarr,Tottenham,47,35,18,23,6,12,24,50.0,12,24,10,14,27,74,22,1
Rodrigo Bentancur,Tottenham,38,20,17,17,4,19,39,48.7,20,25,8,17,36,74,35,1
Djed Spence,Tottenham,45,33,24,14,7,23,30,76.7,7,27,9,18,20,65,68,1
Cristian Romero,Tottenham,35,29,26,8,1,21,30,70.0,9,18,3,15,21,56,57,2
Archie Gray,Tottenham,15,8,4,7,4,7,17,41.2,10,20,10,10,15,30,42,2
Yves Bissouma,Tottenham,48,30,19,25,4,19,34,55.9,15,9,6,3,17,65,37,4
Radu Drăgușin,Tottenham,10,6,8,2,0,6,12,50.0,6,22,16,6,15,25,49,4
Ben Davies,Tottenham,16,11,7,8,1,9,16,56.3,7,26,18,8,12,28,72,1
Lucas Bergvall,Tottenham,39,19,14,20,5,17,32,53.1,15,18,8,10,24,63,22,3
Micky van de Ven,Tottenham,10,6,5,4,1,8,14,57.1,6,9,6,3,10,20,36,1
Mathys Tel,Tottenham,12,5,2,5,5,2,9,22.2,7,8,1,7,1,13,4,2
Wilson Odobert,Tottenham,12,4,4,3,5,7,12,58.3,5,5,0,5,3,15,3,1
Kevin Danso,Tottenham,7,5,4,3,0,6,10,60.0,4,9,9,0,3,10,49,1
Fraser Forster,Tottenham,0,0,0,0,0,0,1,0.0,1,0,0,0,0,0,7,3
Antonín Kinský,Tottenham,3,1,3,0,0,1,1,100.0,0,0,0,0,0,3,7,1
Timo Werner,Tottenham,6,4,3,3,0,3,13,23.1,10,10,1,9,1,7,7,0
Richarlison,Tottenham,4,3,0,3,1,0,2,0.0,2,1,1,0,0,4,8,0
Mikey Moore,Tottenham,0,0,0,0,0,0,2,0.0,2,2,0,2,1,1,3,0
Brandon Austin,Tottenham,0,0,0,0,0,0,0,,0,0,0,0,0,0,1,0
Sergio Reguilón,Tottenham,4,3,1,3,0,2,3,66.7,1,4,0,4,2,6,3,0
Dane Scarlett,Tottenham,1,0,0,1,0,0,0,,0,0,0,0,0,1,1,0
Alfie Dorrington,Tottenham,0,0,0,0,0,0,0,,0,0,0,0,0,0,0,0
Will Lankshear,Tottenham,0,0,0,0,0,0,0,,0,0,0,0,0,0,0,0
Squad Total,Tottenham,639,403,269,266,104,290,569,51.0,279,423,148,275,298,937,742,39
Opponent Total,Tottenham,816,518,394,314,108,406,705,57.6,299,487,135,352,380,1196,885,36
Max Kilman,West Ham,36,22,15,18,3,22,26,84.6,4,56,38,18,38,74,202,5
Aaron Wan-Bissaka,West Ham,67,47,32,30,5,23,31,74.2,8,34,9,25,61,128,119,0
Jarrod Bowen,West Ham,38,25,13,11,14,17,37,45.9,20,21,3,18,16,54,23,0
Mohammed Kudus,West Ham,35,21,7,17,11,10,27,37.0,17,24,1,23,4,39,8,2
Tomáš Souček,West Ham,43,20,20,20,3,23,40,57.5,17,38,20,18,19,62,79,1
Lucas Paquetá,West Ham,66,37,25,30,11,27,54,50.0,27,28,4,24,17,83,37,6
Emerson Palmieri,West Ham,60,31,37,18,5,27,48,56.3,21,32,8,24,21,81,59,0
Alphonse Areola,West Ham,2,2,2,0,0,2,3,66.7,1,0,0,0,0,2,15,2
Konstantinos Mavropanos,West Ham,33,22,22,10,1,15,26,57.7,11,24,17,7,39,72,118,1
Edson Álvarez,West Ham,44,23,24,12,8,15,33,45.5,18,21,8,13,17,61,39,1
Jean-Clair Todibo,West Ham,41,24,26,14,1,25,34,73.5,9,24,12,12,23,64,72,3
Guido Rodríguez,West Ham,32,17,20,12,0,16,32,50.0,16,22,9,13,12,44,30,1
Carlos Soler,West Ham,15,11,8,6,1,7,23,30.4,16,19,6,13,8,23,21,2
Łukasz Fabiański,West Ham,0,0,0,0,0,0,1,0.0,1,0,0,0,0,0,5,1
Michail Antonio,West Ham,2,2,0,1,1,2,3,66.7,1,6,0,6,0,2,2,0
Vladimír Coufal,West Ham,19,12,12,5,2,8,19,42.1,11,13,11,2,8,27,38,1
James Ward-Prowse,West Ham,18,13,8,6,4,6,15,40.0,9,6,3,3,6,24,13,0
Aaron Cresswell,West Ham,11,7,5,5,1,9,11,81.8,2,9,4,5,8,19,36,0
Crysencio Summerville,West Ham,13,7,2,8,3,3,9,33.3,6,13,4,9,0,13,7,0
Oliver Scarles,West Ham,17,11,13,3,1,13,21,61.9,8,14,2,12,10,27,24,0
Niclas Füllkrug,West Ham,3,2,0,1,2,3,4,75.0,1,1,0,1,1,4,12,0
Danny Ings,West Ham,4,2,2,2,0,1,3,33.3,2,5,0,5,1,5,4,0
Andy Irving,West Ham,7,4,3,3,1,1,5,20.0,4,5,1,4,1,8,5,0
Evan Ferguson,West Ham,3,1,0,1,2,0,0,,0,2,1,1,1,4,1,0
Luis Guilherme,West Ham,1,0,1,0,0,0,3,0.0,3,7,0,7,3,4,2,0
Lewis Orford,West Ham,0,0,0,0,0,0,0,,0,1,0,1,1,1,0,0
Kaelan Casey,West Ham,0,0,0,0,0,0,0,,0,0,0,0,0,0,1,0
Squad Total,West Ham,610,363,297,233,80,275,508,54.1,233,425,161,264,315,925,972,26
Opponent Total,West Ham,708,409,299,296,113,334,657,50.8,323,411,136,275,274,982,767,22
Rayan Aït-Nouri,Wolves,85,55,51,26,8,41,68,60.3,27,41,6,35,25,110,70,1
João Gomes,Wolves,105,62,53,48,4,42,103,40.8,61,42,4,38,25,130,32,0
Nélson Semedo,Wolves,59,34,31,21,7,31,54,57.4,23,29,10,19,23,82,101,3
Jørgen Strand Larsen,Wolves,9,6,2,3,4,4,27,14.8,23,18,4,14,6,15,28,0
André,Wolves,88,53,40,40,8,35,61,57.4,26,42,8,34,35,123,30,1
José Sá,Wolves,2,2,2,0,0,2,2,100.0,0,0,0,0,0,2,15,1
Matheus Cunha,Wolves,35,21,16,15,4,11,36,30.6,25,21,1,20,17,52,23,0
Toti Gomes,Wolves,57,41,40,14,3,33,42,78.6,9,28,17,11,24,81,142,5
Matt Doherty,Wolves,37,20,25,12,0,16,24,66.7,8,27,15,12,22,59,95,3
Jean-Ricner Bellegarde,Wolves,37,22,17,17,3,13,19,68.4,6,19,3,16,10,47,18,1
Santiago Bueno,Wolves,40,21,21,18,1,17,22,77.3,5,35,20,15,15,55,70,0
Mario Lemina,Wolves,51,31,27,19,5,20,29,69.0,9,12,7,5,27,78,50,3
Emmanuel Agbadou,Wolves,27,18,18,9,0,11,17,64.7,6,19,13,6,11,38,82,0
Marshall Munetsi,Wolves,22,10,6,10,6,12,21,57.1,9,13,1,12,6,28,16,0
Craig Dawson,Wolves,15,3,8,6,1,12,15,80.0,3,16,11,5,9,24,52,1
Gonçalo Guedes,Wolves,14,4,2,5,7,3,15,20.0,12,9,0,9,5,19,3,0
Sam Johnstone,Wolves,0,0,0,0,0,0,1,0.0,1,0,0,0,0,0,7,0
Pablo Sarabia,Wolves,15,8,4,8,3,9,15,60.0,6,10,0,10,4,19,7,1
Rodrigo Gomes,Wolves,21,13,12,9,0,10,19,52.6,9,8,1,7,5,26,20,1
Hwang Hee-chan,Wolves,6,4,2,1,3,2,6,33.3,4,9,0,9,2,8,11,0
Yerson Mosquera,Wolves,11,7,9,2,0,9,14,64.3,5,13,10,3,10,21,14,0
Tommy Doyle,Wolves,11,6,6,3,2,6,15,40.0,9,11,5,6,5,16,11,1
Carlos Forbs,Wolves,8,5,5,2,1,4,6,66.7,2,3,0,3,1,9,2,1
Daniel Bentley,Wolves,0,0,0,0,0,0,0,,0,0,0,0,0,0,0,0
Pedro Lima,Wolves,1,0,0,0,1,1,3,33.3,2,0,0,0,2,3,5,0
Daniel Podence,Wolves,0,0,0,0,0,0,1,0.0,1,0,0,0,0,0,0,0
Nasser Djiga,Wolves,0,0,0,0,0,0,0,,0,0,0,0,2,2,3,1
Chiquinho,Wolves,0,0,0,0,0,0,0,,0,0,0,0,0,0,0,0
Mateus Mane,Wolves,0,0,0,0,0,0,0,,0,1,0,1,0,0,0,0
Alfie Pond,Wolves,0,0,0,0,0,0,0,,0,0,0,0,0,0,0,0
Boubacar Traoré,Wolves,2,0,0,2,0,1,1,100.0,0,0,0,0,0,2,0,0
Squad Total,Wolves,758,446,397,290,71,345,636,54.2,291,426,136,290,291,1049,907,24
Opponent Total,Wolves,639,396,255,285,99,296,599,49.4,303,368,100,268,296,935,748,37
