player_name,team,tackles,tackles_won,defensive_third_tackles,middle_third_tackles,attacking_third_tackles,dribblers_tackled,dribblers_challenged,dribblers_tackled_percent,challenges_lost,blocks,shots_blocked,passses_blocked,interceptions,tackles_and_interceptions,clearances,shot_leading_errors
Raya,Arsenal,0,0,0,0,0,0,2,0.0,2,0,0,0,2,2,19,6
Saliba,Arsenal,62,37,37,23,2,21,28,75.0,7,25,15,10,21,83,116,6
Rice,Arsenal,52,24,21,25,6,16,37,43.2,21,24,11,13,25,77,44,0
Partey,Arsenal,84,51,24,38,22,44,72,61.1,28,26,7,19,34,118,47,4
Magalhães,Arsenal,25,15,12,8,5,12,16,75.0,4,42,29,13,16,41,93,2
Trossard,Arsenal,28,19,5,14,9,10,32,31.3,22,32,0,32,9,37,17,0
Timber,Arsenal,58,38,17,30,11,18,27,66.7,9,19,4,15,22,80,44,1
Ødegaard,Arsenal,19,11,9,7,3,4,24,16.7,20,5,0,5,5,24,5,1
Martinelli,Arsenal,20,15,8,5,7,7,23,30.4,16,12,0,12,4,24,17,0
Havertz,Arsenal,16,9,3,6,7,4,15,26.7,11,22,4,18,6,22,31,1
Saka,Arsenal,24,13,7,10,7,11,22,50.0,11,22,0,22,3,27,8,0
Merino,Arsenal,43,26,7,24,12,18,33,54.5,15,18,5,13,15,58,25,2
Lewis-Skelly,Arsenal,22,14,10,9,3,10,10,100.0,0,2,1,1,6,28,23,0
White,Arsenal,17,11,10,4,3,14,31,45.2,17,9,7,2,16,33,36,0
Calafiori,Arsenal,26,18,15,9,2,18,29,62.1,11,12,6,6,9,35,25,0
Nwaneri,Arsenal,11,7,4,4,3,7,18,38.9,11,8,2,6,2,13,4,1
Jorginho,Arsenal,12,4,1,7,4,8,20,40.0,12,3,0,3,7,19,2,2
Kiwior,Arsenal,15,7,8,5,2,10,13,76.9,3,8,5,3,4,19,41,2
Jesus,Arsenal,10,6,4,3,3,4,9,44.4,5,10,1,9,4,14,8,0
Sterling,Arsenal,8,4,1,2,5,4,8,50.0,4,3,0,3,1,9,3,0
Zinchenko,Arsenal,4,1,1,2,1,2,7,28.6,5,6,1,5,4,8,6,0
Tierney,Arsenal,6,5,4,1,1,4,6,66.7,2,0,0,0,2,8,5,0
Butler-Oyedeji,Arsenal,0,0,0,0,0,0,0,,0,0,0,0,0,0,0,0
Tomiyasu,Arsenal,0,0,0,0,0,0,0,,0,0,0,0,0,0,1,0
Nelson,Arsenal,1,0,0,1,0,0,1,0.0,1,0,0,0,0,1,1,0
Martínez,Aston Villa,3,3,3,0,0,2,2,100.0,0,1,0,1,0,3,17,6
Tielemans,Aston Villa,83,57,31,44,8,40,73,54.8,33,37,16,21,22,105,47,4
Rogers,Aston Villa,40,21,15,14,11,22,44,50.0,22,26,7,19,5,45,20,2
Konsa,Aston Villa,32,17,19,9,4,18,23,78.3,5,18,10,8,21,53,107,4
Watkins,Aston Villa,10,7,0,6,4,3,11,27.3,8,11,3,8,8,18,15,2
Digne,Aston Villa,65,38,40,16,9,44,66,66.7,22,23,4,19,25,90,89,1
McGinn,Aston Villa,31,22,10,13,8,11,29,37.9,18,21,2,19,14,45,17,3
Cash,Aston Villa,50,29,26,20,4,25,36,69.4,11,20,8,12,21,71,63,2
Torres,Aston Villa,20,14,11,7,2,9,15,60.0,6,14,10,4,9,29,66,2
Ramsey,Aston Villa,30,15,14,10,6,10,20,50.0,10,23,4,19,8,38,8,1
Kamara,Aston Villa,49,20,28,17,4,28,55,50.9,27,17,7,10,19,68,50,3
Onana,Aston Villa,49,24,22,23,4,14,27,51.9,13,15,7,8,25,74,41,3
Bailey,Aston Villa,6,4,1,3,2,2,10,20.0,8,6,0,6,3,9,12,0
Mings,Aston Villa,7,6,6,1,0,2,2,100.0,0,13,11,2,7,14,61,1
Maatsen,Aston Villa,27,15,16,8,3,16,22,72.7,6,11,0,11,15,42,34,2
Carlos,Aston Villa,8,3,6,1,1,4,6,66.7,2,13,7,6,5,13,36,2
Asensio,Aston Villa,7,5,0,7,0,3,9,33.3,6,4,0,4,2,9,3,0
Disasi,Aston Villa,8,5,7,1,0,3,7,42.9,4,4,1,3,5,13,18,0
Bogarde,Aston Villa,14,6,6,6,2,10,16,62.5,6,5,3,2,1,15,13,0
García,Aston Villa,9,5,5,3,1,4,8,50.0,4,2,0,2,2,11,10,2
Durán,Aston Villa,8,7,1,2,5,1,4,25.0,3,5,0,5,0,8,13,0
Rashford,Aston Villa,10,7,2,3,5,4,6,66.7,2,2,0,2,1,11,3,0
Barkley,Aston Villa,14,3,4,10,0,9,14,64.3,5,9,3,6,10,24,5,0
Jaden Philogene Bidace,Aston Villa,11,5,4,7,0,4,6,66.7,2,5,0,5,3,14,2,1
Malen,Aston Villa,7,4,3,3,1,1,4,25.0,3,1,0,1,0,7,1,0
Olsen,Aston Villa,1,0,1,0,0,1,1,100.0,0,0,0,0,0,1,2,1
Nedeljković,Aston Villa,7,5,1,3,3,2,3,66.7,1,1,0,1,0,7,3,0
Buendía,Aston Villa,6,6,3,2,1,0,5,0.0,5,5,1,4,0,6,2,0
Kerkez,Bournemouth,52,26,25,20,7,24,38,63.2,14,36,11,25,44,96,103,3
Semenyo,Bournemouth,53,34,16,24,13,16,42,38.1,26,61,8,53,10,63,38,2
Zabarnyi,Bournemouth,48,33,28,19,1,32,47,68.1,15,33,20,13,39,87,175,2
Cook,Bournemouth,81,42,41,36,4,37,67,55.2,30,30,11,19,40,121,68,0
Arrizabalaga,Bournemouth,1,0,1,0,0,0,2,0.0,2,1,0,1,0,1,15,3
Kluivert,Bournemouth,21,9,4,10,7,4,21,19.0,17,24,0,24,13,34,23,1
Christie,Bournemouth,54,33,19,27,8,27,64,42.2,37,44,11,33,30,84,51,3
Evanilson,Bournemouth,16,10,6,5,5,8,12,66.7,4,11,2,9,0,16,21,0
Huijsen,Bournemouth,36,26,19,16,1,18,28,64.3,10,36,28,8,50,86,185,4
Ouattara,Bournemouth,35,26,14,11,10,17,41,41.5,24,36,10,26,11,46,51,0
Adams,Bournemouth,78,48,24,47,7,36,68,52.9,32,33,10,23,32,110,40,0
Tavernier,Bournemouth,42,24,14,19,9,10,26,38.5,16,16,3,13,5,47,11,0
Smith,Bournemouth,22,10,11,5,6,12,25,48.0,13,12,5,7,14,36,48,1
Senesi,Bournemouth,36,21,23,11,2,14,30,46.7,16,15,7,8,11,47,56,0
Brooks,Bournemouth,12,5,2,7,3,1,14,7.1,13,16,2,14,5,17,8,1
Scott,Bournemouth,27,14,11,8,8,19,42,45.2,23,17,4,13,10,37,15,0
Hill,Bournemouth,15,8,6,6,3,3,11,27.3,8,5,0,5,9,24,31,0
Araujo,Bournemouth,8,3,4,4,0,5,12,41.7,7,3,0,3,6,14,16,0
Travers,Bournemouth,0,0,0,0,0,0,0,,0,0,0,0,0,0,5,0
Ünal,Bournemouth,1,0,0,0,1,0,3,0.0,3,1,0,1,0,1,6,0
Neto,Bournemouth,0,0,0,0,0,0,0,,0,0,0,0,0,0,1,1
Sinisterra,Bournemouth,7,2,3,2,2,0,4,0.0,4,3,0,3,1,8,8,0
Billing,Bournemouth,14,5,7,6,1,3,4,75.0,1,3,0,3,5,19,2,0
Aarons,Bournemouth,2,2,1,1,0,1,1,100.0,0,3,1,2,1,3,0,0
Jebbison,Bournemouth,3,2,2,1,0,3,5,60.0,2,2,1,1,1,4,1,0
Winterburn,Bournemouth,0,0,0,0,0,0,1,0.0,1,0,0,0,2,2,0,0
Soler,Bournemouth,1,1,1,0,0,1,1,100.0,0,1,0,1,0,1,0,0
Rees-Dottin,Bournemouth,0,0,0,0,0,0,0,,0,0,0,0,0,0,0,0
Silcott-Duberry,Bournemouth,1,1,0,0,1,1,1,100.0,0,0,0,0,0,1,0,0
Collins,Brentford,37,22,22,11,4,22,35,62.9,13,72,52,20,33,70,219,2
Mbeumo,Brentford,45,29,17,14,14,18,31,58.1,13,24,3,21,14,59,52,1
Flekken,Brentford,4,4,4,0,0,3,9,33.3,6,2,0,2,0,4,26,4
Lewis-Potter,Brentford,46,26,25,15,6,28,46,60.9,18,26,9,17,19,65,72,3
Damsgaard,Brentford,80,43,27,27,26,30,77,39.0,47,39,2,37,26,106,30,2
Wissa,Brentford,22,12,6,8,8,11,27,40.7,16,29,8,21,8,30,20,3
Nørgaard,Brentford,76,46,35,34,7,45,74,60.8,29,51,19,32,46,122,65,1
Sepp van den Berg,Brentford,37,22,23,10,4,18,27,66.7,9,51,37,14,20,57,124,3
Janelt,Brentford,38,22,14,13,11,21,36,58.3,15,33,9,24,27,65,53,1
Schade,Brentford,36,23,14,10,12,12,20,60.0,8,17,2,15,5,41,32,0
Pinnock,Brentford,35,19,15,16,4,13,24,54.2,11,29,18,11,24,59,142,4
Ajer,Brentford,25,17,14,10,1,14,26,53.8,12,17,4,13,12,37,49,0
Yarmoliuk,Brentford,42,25,16,20,6,25,49,51.0,24,24,7,17,12,54,31,0
Roerslev,Brentford,18,8,14,3,1,11,28,39.3,17,12,5,7,4,22,35,0
Jensen,Brentford,14,10,6,6,2,8,16,50.0,8,13,4,9,8,22,13,1
Kayode,Brentford,15,10,11,4,0,9,11,81.8,2,2,0,2,5,20,15,0
Carvalho,Brentford,13,9,4,4,5,6,13,46.2,7,6,1,5,3,16,2,0
Mee,Brentford,2,2,0,2,0,1,1,100.0,0,3,3,0,4,6,7,0
Thiago,Brentford,4,3,1,1,2,0,1,0.0,1,2,0,2,2,6,2,1
Hákon Rafn Valdimarsson,Brentford,0,0,0,0,0,0,0,,0,0,0,0,0,0,2,0
Maghoma,Brentford,2,1,0,2,0,1,3,33.3,2,2,2,0,1,3,2,0
Henry,Brentford,0,0,0,0,0,0,4,0.0,4,3,1,2,1,1,2,0
Yunus Emre Konak,Brentford,4,4,0,4,0,1,2,50.0,1,2,0,2,0,4,0,0
Jisoo,Brentford,0,0,0,0,0,0,0,,0,0,0,0,0,0,2,0
Onyeka,Brentford,0,0,0,0,0,0,0,,0,0,0,0,0,0,0,0
Nunes,Brentford,3,2,2,0,1,2,2,100.0,0,0,0,0,0,3,2,0
Meghoma,Brentford,0,0,0,0,0,0,0,,0,0,0,0,0,0,0,0
Trevitt,Brentford,1,1,1,0,0,0,0,,0,0,0,0,0,1,0,0
Verbruggen,Brighton,0,0,0,0,0,0,3,0.0,3,1,0,1,0,0,28,5
Jan Paul van Hecke,Brighton,41,27,21,19,1,21,39,53.8,18,33,19,14,23,64,138,2
Baleba,Brighton,73,42,25,33,15,46,76,60.5,30,44,10,34,43,116,42,1
Mitoma,Brighton,44,26,15,13,16,19,48,39.6,29,48,3,45,13,57,10,0
Estupiñán,Brighton,60,40,31,22,7,32,47,68.1,15,17,3,14,36,96,63,2
Dunk,Brighton,17,10,8,7,2,11,19,57.9,8,28,18,10,13,30,79,2
Welbeck,Brighton,24,15,6,13,5,7,19,36.8,12,18,3,15,5,29,14,0
Pedro,Brighton,16,12,6,6,4,4,11,36.4,7,12,0,12,9,25,12,0
Hinshelwood,Brighton,26,18,8,10,8,11,27,40.7,16,8,3,5,15,41,37,1
Ayari,Brighton,56,31,15,30,11,23,53,43.4,30,23,6,17,20,76,25,0
Veltman,Brighton,42,28,23,16,3,30,51,58.8,21,22,7,15,18,60,66,0
Rutter,Brighton,39,15,13,18,8,14,36,38.9,22,20,3,17,10,49,13,2
Minteh,Brighton,47,34,25,13,9,17,45,37.8,28,21,0,21,11,58,31,0
O'Riley,Brighton,16,9,4,8,4,4,13,30.8,9,7,3,4,13,29,9,1
Adingra,Brighton,23,14,10,8,5,10,24,41.7,14,12,0,12,8,31,6,2
Lamptey,Brighton,17,11,8,9,0,9,25,36.0,16,15,7,8,7,24,23,1
Igor,Brighton,4,4,2,1,1,4,10,40.0,6,23,14,9,4,8,39,1
Webster,Brighton,9,6,5,3,1,5,12,41.7,7,12,9,3,18,27,33,1
Wieffer,Brighton,46,27,20,22,4,26,38,68.4,12,15,1,14,14,60,24,3
Gruda,Brighton,14,6,6,5,3,7,14,50.0,7,8,0,8,2,16,5,1
Kadioglu,Brighton,10,6,4,5,1,6,15,40.0,9,2,2,0,8,18,17,0
Gómez,Brighton,17,10,8,7,2,9,19,47.4,10,12,0,12,7,24,10,1
Milner,Brighton,5,2,1,3,1,3,3,100.0,0,4,2,2,2,7,2,1
Enciso,Brighton,0,0,0,0,0,0,2,0.0,2,2,0,2,0,0,1,0
Ferguson,Brighton,4,3,0,3,1,2,5,40.0,3,3,1,2,0,4,4,0
Steele,Brighton,0,0,0,0,0,0,0,,0,0,0,0,0,0,1,0
March,Brighton,6,3,2,2,2,5,8,62.5,3,3,0,3,2,8,2,1
Gilmour,Brighton,3,3,2,1,0,3,4,75.0,1,1,0,1,0,3,1,0
Cashin,Brighton,0,0,0,0,0,0,1,0.0,1,0,0,0,0,0,2,0
Moder,Brighton,1,0,1,0,0,0,2,0.0,2,0,0,0,0,1,3,0
Sarmiento,Brighton,0,0,0,0,0,0,0,,0,0,0,0,0,0,0,0
Caicedo,Chelsea,107,67,40,52,15,51,82,62.2,31,46,10,36,49,156,56,1
Palmer,Chelsea,28,17,11,10,7,9,23,39.1,14,15,1,14,11,39,18,1
Colwill,Chelsea,45,32,24,18,3,17,26,65.4,9,36,25,11,32,77,108,4
Cucurella,Chelsea,61,39,30,26,5,27,54,50.0,27,46,15,31,25,86,86,3
Fernández,Chelsea,64,32,17,29,18,31,84,36.9,53,38,7,31,13,77,22,4
Sánchez,Chelsea,0,0,0,0,0,0,1,0.0,1,0,0,0,2,2,22,9
Jackson,Chelsea,22,13,6,7,9,5,10,50.0,5,15,2,13,3,25,15,0
Madueke,Chelsea,22,15,7,12,3,13,36,36.1,23,17,0,17,8,30,11,0
Neto,Chelsea,22,9,9,9,4,8,19,42.1,11,14,2,12,9,31,6,0
Gusto,Chelsea,44,28,27,15,2,25,48,52.1,23,29,8,21,24,68,48,5
Sancho,Chelsea,11,7,3,2,6,5,12,41.7,7,10,0,10,2,13,6,2
Fofana,Chelsea,13,12,6,7,0,6,14,42.9,8,14,9,5,14,27,55,2
Adarabioyo,Chelsea,14,10,10,4,0,8,12,66.7,4,9,7,2,10,24,62,0
Chalobah,Chelsea,11,7,5,6,0,7,8,87.5,1,6,3,3,10,21,48,1
Lavia,Chelsea,22,13,5,13,4,10,21,47.6,11,6,0,6,16,38,10,1
James,Chelsea,9,9,5,3,1,3,9,33.3,6,12,4,8,13,22,18,4
Nkunku,Chelsea,12,8,3,4,5,6,8,75.0,2,9,2,7,7,19,10,0
Jørgensen,Chelsea,0,0,0,0,0,0,0,,0,0,0,0,0,0,0,3
Disasi,Chelsea,7,4,5,1,1,6,11,54.5,5,4,1,3,2,9,11,1
Félix,Chelsea,8,3,2,5,1,5,9,55.6,4,2,0,2,3,11,2,0
Badiashile,Chelsea,9,6,5,4,0,4,5,80.0,1,2,2,0,6,15,12,2
Dewsbury-Hall,Chelsea,8,5,1,1,6,4,6,66.7,2,2,0,2,1,9,8,1
Acheampong,Chelsea,2,1,2,0,0,2,2,100.0,0,1,0,1,1,3,2,0
Veiga,Chelsea,9,6,6,3,0,4,12,33.3,8,3,1,2,1,10,2,0
Mudryk,Chelsea,2,2,2,0,0,0,0,,0,3,1,2,0,2,1,0
George,Chelsea,2,0,2,0,0,2,3,66.7,1,0,0,0,1,3,1,0
Guiu,Chelsea,1,1,0,1,0,1,1,100.0,0,0,0,0,0,1,0,0
Amougou,Chelsea,0,0,0,0,0,0,0,,0,0,0,0,0,0,0,0
Mheuka,Chelsea,0,0,0,0,0,0,0,,0,0,0,0,0,0,0,0
Henderson,Crystal Palace,2,1,2,0,0,2,6,33.3,4,0,0,0,0,2,22,0
Mitchell,Crystal Palace,88,54,55,26,7,23,43,53.5,20,63,12,51,14,102,100,2
Muñoz,Crystal Palace,115,75,54,38,23,52,92,56.5,40,37,4,33,41,156,104,1
Guéhi,Crystal Palace,61,34,36,23,2,31,47,66.0,16,55,23,32,28,89,162,2
Lacroix,Crystal Palace,67,40,51,15,1,32,47,68.1,15,44,19,25,52,119,191,2
Mateta,Crystal Palace,17,12,4,11,2,3,16,18.8,13,18,4,14,2,19,22,0
Eze,Crystal Palace,39,22,14,16,9,17,36,47.2,19,27,0,27,11,50,9,3
Sarr,Crystal Palace,21,10,9,9,3,7,23,30.4,16,25,8,17,9,30,37,0
Lerma,Crystal Palace,32,16,13,15,4,19,35,54.3,16,35,16,19,37,69,65,1
Hughes,Crystal Palace,62,33,18,31,13,27,59,45.8,32,31,14,17,21,83,24,3
Richards,Crystal Palace,44,28,21,17,6,23,39,59.0,16,37,13,24,19,63,101,0
Wharton,Crystal Palace,34,14,14,16,4,17,44,38.6,27,11,2,9,20,54,27,0
Kamada,Crystal Palace,46,28,19,23,4,14,39,35.9,25,22,5,17,16,62,14,0
Chalobah,Crystal Palace,20,16,7,12,1,12,23,52.2,11,19,9,10,19,39,57,3
Nketiah,Crystal Palace,14,7,6,4,4,6,12,50.0,6,10,1,9,2,16,11,0
Clyne,Crystal Palace,12,8,8,3,1,6,11,54.5,5,4,2,2,3,15,14,1
Doucouré,Crystal Palace,16,8,6,8,2,5,11,45.5,6,4,0,4,11,27,10,1
Devenny,Crystal Palace,14,9,6,7,1,7,14,50.0,7,3,0,3,0,14,10,0
Édouard,Crystal Palace,1,0,0,1,0,0,2,0.0,2,1,0,1,0,1,1,0
Andersen,Crystal Palace,1,1,1,0,0,1,2,50.0,1,0,0,0,0,1,7,0
Riad,Crystal Palace,5,2,2,2,1,2,3,66.7,1,0,0,0,2,7,0,0
Chilwell,Crystal Palace,5,5,2,3,0,0,4,0.0,4,4,2,2,4,9,12,0
Schlupp,Crystal Palace,2,0,1,0,1,0,3,0.0,3,6,0,6,0,2,2,0
Esse,Crystal Palace,2,2,2,0,0,2,2,100.0,0,1,0,1,1,3,0,0
França,Crystal Palace,1,0,0,1,0,0,0,,0,0,0,0,0,1,0,0
Ayew,Crystal Palace,1,0,0,0,1,0,0,,0,0,0,0,0,1,0,0
Kporha,Crystal Palace,2,1,2,0,0,2,2,100.0,0,0,0,0,0,2,1,0
Agbinone,Crystal Palace,2,1,0,2,0,0,0,,0,0,0,0,0,2,0,0
Ward,Crystal Palace,0,0,0,0,0,0,0,,0,0,0,0,0,0,0,0
Pickford,Everton,1,0,1,0,0,1,2,50.0,1,0,0,0,1,2,29,2
Tarkowski,Everton,64,40,39,22,3,24,39,61.5,15,57,42,15,41,105,213,4
Mykolenko,Everton,55,33,33,14,8,26,52,50.0,26,25,10,15,39,94,137,2
Idrissa Gana Gueye,Everton,125,74,57,52,16,54,91,59.3,37,48,9,39,44,169,33,1
Doucouré,Everton,46,27,21,18,7,13,41,31.7,28,31,6,25,9,55,19,1
Branthwaite,Everton,36,20,26,10,0,20,27,74.1,7,31,23,8,25,61,190,4
Ndiaye,Everton,48,25,18,15,15,19,45,42.2,26,28,5,23,17,65,24,1
Harrison,Everton,32,22,12,12,8,15,43,34.9,28,18,2,16,9,41,32,2
Calvert-Lewin,Everton,9,7,1,4,4,2,6,33.3,4,6,2,4,6,15,19,0
Young,Everton,53,30,23,23,7,32,53,60.4,21,13,4,9,24,77,64,1
Garner,Everton,42,28,24,16,2,20,36,55.6,16,19,4,15,20,62,36,0
O'Brien,Everton,24,16,19,5,0,16,24,66.7,8,16,4,12,4,28,80,0
Lindstrøm,Everton,45,25,24,19,2,19,55,34.5,36,15,3,12,12,57,17,0
McNeil,Everton,12,7,5,5,2,9,20,45.0,11,7,0,7,5,17,2,1
Mangala,Everton,16,8,3,11,2,5,8,62.5,3,8,3,5,21,37,24,1
Beto,Everton,14,6,2,8,4,5,8,62.5,3,10,1,9,3,17,21,1
Keane,Everton,10,7,7,2,1,7,13,53.8,6,11,7,4,15,25,61,2
Alcaraz,Everton,11,5,5,3,3,3,9,33.3,6,7,1,6,4,15,10,0
Iroegbunam,Everton,29,14,14,10,5,14,23,60.9,9,18,4,14,16,45,12,1
Broja,Everton,3,1,1,1,1,0,0,,0,3,0,3,1,4,4,0
Patterson,Everton,11,6,7,4,0,7,14,50.0,7,2,0,2,2,13,7,0
Coleman,Everton,3,2,2,1,0,3,4,75.0,1,5,3,2,1,4,8,0
Dixon,Everton,5,5,3,2,0,4,4,100.0,0,1,0,1,1,6,3,0
Armstrong,Everton,0,0,0,0,0,0,1,0.0,1,0,0,0,0,0,1,0
Chermiti,Everton,0,0,0,0,0,0,1,0.0,1,0,0,0,0,0,0,0
Holgate,Everton,0,0,0,0,0,0,0,,0,0,0,0,0,0,0,0
Leno,Fulham,2,2,2,0,0,2,2,100.0,0,1,0,1,0,2,10,5
Iwobi,Fulham,42,24,13,21,8,21,32,65.6,11,25,1,24,13,55,28,0
Robinson,Fulham,90,57,53,30,7,44,89,49.4,45,37,7,30,57,147,124,2
Bassey,Fulham,53,33,34,19,0,21,30,70.0,9,39,17,22,19,72,111,8
Jiménez,Fulham,33,23,8,17,8,7,20,35.0,13,19,5,14,10,43,19,3
Andersen,Fulham,26,18,19,6,1,14,21,66.7,7,33,26,7,31,57,174,1
Lukić,Fulham,66,37,21,39,6,21,53,39.6,32,19,7,12,26,92,32,0
Berge,Fulham,48,28,22,22,4,25,37,67.6,12,26,8,18,21,69,36,1
Pereira,Fulham,23,13,7,11,5,10,41,24.4,31,16,2,14,8,31,17,3
Emile Smith Rowe,Fulham,31,18,7,14,10,8,24,33.3,16,21,2,19,11,42,16,0
Tete,Fulham,50,34,24,14,12,20,34,58.8,14,25,8,17,29,79,53,0
Castagne,Fulham,46,29,28,15,3,26,45,57.8,19,15,6,9,22,68,83,0
Traoré,Fulham,17,12,8,4,5,5,13,38.5,8,7,0,7,1,18,6,3
Diop,Fulham,26,12,18,8,0,13,18,72.2,5,10,7,3,9,35,72,2
Wilson,Fulham,16,11,10,3,3,9,15,60.0,6,13,1,12,5,21,7,1
Muniz,Fulham,10,5,3,5,2,4,4,100.0,0,9,2,7,5,15,14,0
Sessegnon,Fulham,27,13,11,11,5,9,19,47.4,10,13,1,12,3,30,17,0
Nelson,Fulham,8,6,3,3,2,5,13,38.5,8,11,0,11,5,13,2,0
Cuenca,Fulham,2,2,2,0,0,2,5,40.0,3,3,3,0,2,4,21,0
Cairney,Fulham,11,5,4,2,5,4,7,57.1,3,5,1,4,4,15,1,1
Willian,Fulham,4,2,0,3,1,2,6,33.3,4,0,0,0,1,5,1,0
King,Fulham,5,3,2,3,0,0,2,0.0,2,2,0,2,1,6,1,0
Reed,Fulham,6,3,3,2,1,1,3,33.3,2,1,0,1,1,7,3,0
Godo,Fulham,0,0,0,0,0,0,0,,0,1,0,1,1,1,0,0
Vinícius,Fulham,0,0,0,0,0,0,1,0.0,1,1,0,1,0,0,0,0
Stansfield,Fulham,0,0,0,0,0,0,0,,0,0,0,0,0,0,0,0
O'Shea,Ipswich Town,47,30,33,11,3,20,31,64.5,11,61,49,12,31,78,211,4
Delap,Ipswich Town,11,8,3,3,5,2,14,14.3,12,8,0,8,2,13,28,0
Davis,Ipswich Town,45,26,32,9,4,29,46,63.0,17,24,8,16,25,70,72,3
Morsy,Ipswich Town,65,38,38,23,4,26,58,44.8,32,32,13,19,29,94,44,4
Hutchinson,Ipswich Town,31,12,14,10,7,13,47,27.7,34,25,1,24,10,41,13,1
Greaves,Ipswich Town,38,20,20,17,1,21,33,63.6,12,38,25,13,19,57,133,3
Cajuste,Ipswich Town,42,20,19,22,1,21,49,42.9,28,24,9,15,25,67,33,2
Muric,Ipswich Town,0,0,0,0,0,0,2,0.0,2,0,0,0,0,0,10,5
Tuanzebe,Ipswich Town,29,17,20,3,6,16,24,66.7,8,18,9,9,22,51,54,1
Burgess,Ipswich Town,17,12,14,3,0,9,11,81.8,2,20,15,5,14,31,128,3
Johnson,Ipswich Town,38,22,23,12,3,20,41,48.8,21,22,5,17,13,51,54,1
Phillips,Ipswich Town,35,19,8,20,7,15,39,38.5,24,35,6,29,19,54,37,2
Szmodics,Ipswich Town,15,9,4,9,2,6,23,26.1,17,10,2,8,6,21,14,0
Woolfenden,Ipswich Town,9,6,5,4,0,2,5,40.0,3,21,14,7,19,28,76,0
Palmer,Ipswich Town,0,0,0,0,0,0,0,,0,0,0,0,0,0,12,0
Burns,Ipswich Town,13,11,1,9,3,4,10,40.0,6,7,2,5,10,23,13,2
Clarke,Ipswich Town,28,17,11,9,8,16,32,50.0,16,6,0,6,7,35,29,1
Enciso,Ipswich Town,12,9,3,6,3,4,11,36.4,7,5,1,4,1,13,6,0
Chaplin,Ipswich Town,12,5,4,6,2,6,13,46.2,7,8,1,7,3,15,3,0
Broadhead,Ipswich Town,7,3,2,5,0,3,9,33.3,6,6,1,5,4,11,5,0
Walton,Ipswich Town,0,0,0,0,0,0,1,0.0,1,0,0,0,0,0,1,1
Jaden Philogene Bidace,Ipswich Town,14,7,6,6,2,8,15,53.3,7,11,1,10,10,24,9,1
Taylor,Ipswich Town,20,10,6,11,3,12,25,48.0,13,10,3,7,9,29,24,0
Clarke,Ipswich Town,5,3,3,2,0,3,6,50.0,3,5,4,1,4,9,14,3
Hirst,Ipswich Town,3,3,1,0,2,1,3,33.3,2,1,1,0,2,5,10,0
Townsend,Ipswich Town,11,8,9,2,0,8,11,72.7,3,8,6,2,4,15,16,0
Ogbene,Ipswich Town,7,3,1,2,4,2,4,50.0,2,1,0,1,1,8,3,0
Luongo,Ipswich Town,8,5,6,1,1,4,7,57.1,3,4,2,2,2,10,2,0
Godfrey,Ipswich Town,1,0,1,0,0,1,1,100.0,0,1,1,0,2,3,3,0
Ali Al Hamadi,Ipswich Town,1,0,0,0,1,0,2,0.0,2,0,0,0,0,1,2,0
Harness,Ipswich Town,1,0,0,0,1,0,3,0.0,3,2,1,1,0,1,1,0
Edmundson,Ipswich Town,0,0,0,0,0,0,0,,0,0,0,0,0,0,0,0
Vardy,Leicester City,19,13,7,7,5,4,13,30.8,9,8,4,4,5,24,23,0
Justin,Leicester City,50,30,25,20,5,28,51,54.9,23,43,14,29,45,95,132,3
Faes,Leicester City,39,23,25,12,2,23,43,53.5,20,45,33,12,26,65,173,4
Victor Bernth Kristiansen,Leicester City,85,50,54,26,5,47,87,54.0,40,37,14,23,40,125,72,3
Hermansen,Leicester City,1,1,1,0,0,1,1,100.0,0,1,0,1,0,1,13,4
Ndidi,Leicester City,81,50,45,29,7,27,54,50.0,27,47,19,28,29,110,78,0
Bilal El Khannouss,Leicester City,47,27,15,27,5,15,29,51.7,14,22,4,18,6,53,10,3
Soumaré,Leicester City,33,18,21,11,1,18,30,60.0,12,22,10,12,25,58,31,3
Winks,Leicester City,24,11,12,10,2,13,30,43.3,17,19,7,12,9,33,20,0
Coady,Leicester City,12,8,6,5,1,3,6,50.0,3,28,20,8,13,25,67,2
Ayew,Leicester City,26,14,7,14,5,6,19,31.6,13,19,1,18,12,38,17,0
Mavididi,Leicester City,34,19,16,10,8,14,42,33.3,28,26,2,24,11,45,15,0
Vestergaard,Leicester City,22,10,16,6,0,9,15,60.0,6,21,14,7,16,38,74,1
Buonanotte,Leicester City,53,32,17,22,14,21,67,31.3,46,33,6,27,12,65,14,0
Okoli,Leicester City,25,14,8,15,2,11,18,61.1,7,24,14,10,15,40,79,3
Thomas,Leicester City,27,21,21,4,2,19,35,54.3,16,13,5,8,18,45,41,1
Skipp,Leicester City,20,4,5,12,3,9,15,60.0,6,19,6,13,10,30,11,2
Bobby De Cordova-Reid,Leicester City,9,4,3,6,0,4,14,28.6,10,6,1,5,0,9,10,0
Stolarczyk,Leicester City,2,1,2,0,0,1,2,50.0,1,0,0,0,0,2,6,0
McAteer,Leicester City,18,14,10,5,3,10,23,43.5,13,15,1,14,3,21,15,0
Abdul Fatawu Issahaku,Leicester City,21,15,13,2,6,11,19,57.9,8,7,0,7,4,25,12,0
Daka,Leicester City,17,9,4,9,4,7,17,41.2,10,7,1,6,1,18,10,0
Pereira,Leicester City,11,6,4,4,3,6,12,50.0,6,6,2,4,2,13,10,0
Ward,Leicester City,0,0,0,0,0,0,0,,0,0,0,0,0,0,1,0
Choudhury,Leicester City,1,1,1,0,0,1,3,33.3,2,4,2,2,5,6,2,0
Coulibaly,Leicester City,6,4,4,2,0,2,2,100.0,0,3,1,2,5,11,1,0
Monga,Leicester City,1,1,0,1,0,1,1,100.0,0,3,2,1,0,1,1,0
Édouard,Leicester City,1,1,1,0,0,0,0,,0,0,0,0,0,1,1,0
Evans,Leicester City,0,0,0,0,0,0,1,0.0,1,0,0,0,0,0,1,0
Alves,Leicester City,0,0,0,0,0,0,0,,0,0,0,0,0,0,0,0
Golding,Leicester City,0,0,0,0,0,0,0,,0,0,0,0,0,0,0,0
Virgil van Dijk,Liverpool,35,17,17,16,2,11,20,55.0,9,27,16,11,54,89,184,4
Salah,Liverpool,21,11,7,5,9,8,17,47.1,9,11,0,11,7,28,5,0
Gravenberch,Liverpool,67,35,27,29,11,32,54,59.3,22,35,10,25,57,124,57,2
Alexis Mac Allister,Liverpool,95,58,28,51,16,55,104,52.9,49,61,6,55,22,117,29,1
Konaté,Liverpool,38,26,25,11,2,24,34,70.6,10,28,15,13,12,50,128,2
Robertson,Liverpool,39,22,25,10,4,31,50,62.0,19,10,4,6,21,60,53,2
Alexander-Arnold,Liverpool,71,50,43,19,9,48,103,46.6,55,26,9,17,31,102,54,4
Szoboszlai,Liverpool,33,20,12,16,5,15,39,38.5,24,37,4,33,9,42,19,2
Díaz,Liverpool,35,23,11,18,6,13,37,35.1,24,19,0,19,7,42,7,1
Alisson,Liverpool,1,0,1,0,0,0,1,0.0,1,0,0,0,0,1,13,1
Gakpo,Liverpool,27,15,5,13,9,12,24,50.0,12,21,2,19,11,38,16,1
Jones,Liverpool,37,21,6,22,9,17,26,65.4,9,19,9,10,7,44,8,3
Jota,Liverpool,14,8,2,8,4,7,19,36.8,12,9,0,9,7,21,6,0
Kelleher,Liverpool,0,0,0,0,0,0,0,,0,0,0,0,0,0,1,2
Núñez,Liverpool,20,17,11,3,6,6,16,37.5,10,6,0,6,3,23,12,0
Tsimikas,Liverpool,29,18,13,11,5,13,20,65.0,7,5,2,3,10,39,20,0
Gomez,Liverpool,13,10,5,7,1,11,16,68.8,5,9,6,3,7,20,20,2
Bradley,Liverpool,13,10,7,4,2,10,20,50.0,10,5,0,5,4,17,25,0
Quansah,Liverpool,11,8,8,3,0,6,8,75.0,2,8,7,1,6,17,18,1
Elliott,Liverpool,4,3,2,1,1,1,5,20.0,4,5,1,4,1,5,2,1
Endo,Liverpool,11,8,6,5,0,6,10,60.0,4,7,1,6,3,14,7,0
Chiesa,Liverpool,0,0,0,0,0,0,2,0.0,2,1,0,1,0,0,0,1
Jaros,Liverpool,0,0,0,0,0,0,0,,0,0,0,0,0,0,0,0
Danns,Liverpool,0,0,0,0,0,0,1,0.0,1,0,0,0,0,0,0,0
Gvardiol,Manchester City,54,36,24,19,11,20,38,52.6,18,41,20,21,39,93,117,8
Haaland,Manchester City,10,5,3,3,4,2,6,33.3,4,11,1,10,5,15,23,0
Silva,Manchester City,53,35,15,29,9,24,52,46.2,28,33,7,26,20,73,29,3
Ederson,Manchester City,0,0,0,0,0,0,2,0.0,2,0,0,0,1,1,9,2
Kovačić,Manchester City,68,38,22,38,8,31,65,47.7,34,20,0,20,22,90,20,1
Dias,Manchester City,16,10,6,9,1,7,11,63.6,4,19,16,3,18,34,61,3
Gündoğan,Manchester City,24,13,4,15,5,10,23,43.5,13,14,0,14,13,37,22,0
Lewis,Manchester City,30,19,13,12,5,13,21,61.9,8,28,7,21,13,43,45,1
Akanji,Manchester City,17,11,10,4,3,9,15,60.0,6,11,8,3,7,24,61,3
Sávio,Manchester City,23,17,5,10,8,10,19,52.6,9,14,2,12,6,29,9,1
Foden,Manchester City,12,5,5,4,3,7,18,38.9,11,13,1,12,9,21,7,1
Kevin De Bruyne,Manchester City,17,9,7,5,5,5,23,21.7,18,8,0,8,7,24,10,1
Nunes,Manchester City,32,21,13,13,6,15,34,44.1,19,14,3,11,13,45,35,1
Doku,Manchester City,30,21,9,12,9,8,15,53.3,7,10,1,9,4,34,2,0
Ortega,Manchester City,0,0,0,0,0,0,1,0.0,1,0,0,0,0,0,11,1
Marmoush,Manchester City,11,6,2,7,2,7,15,46.7,8,15,1,14,5,16,3,0
Walker,Manchester City,17,10,7,7,3,14,26,53.8,12,13,4,9,3,20,13,1
Aké,Manchester City,9,7,7,2,0,4,6,66.7,2,7,2,5,3,12,22,1
González,Manchester City,15,6,5,6,4,6,11,54.5,5,9,0,9,5,20,17,0
Grealish,Manchester City,9,5,4,2,3,2,5,40.0,3,12,2,10,2,11,5,1
Stones,Manchester City,6,2,3,2,1,5,5,100.0,0,5,3,2,4,10,19,1
O’Reilly,Manchester City,9,4,3,3,3,4,8,50.0,4,5,1,4,4,13,12,0
Khusanov,Manchester City,5,4,4,1,0,2,3,66.7,1,5,4,1,3,8,29,1
Mcatee,Manchester City,5,2,0,4,1,1,7,14.3,6,8,0,8,2,7,1,0
Simpson-Pusey,Manchester City,1,0,1,0,0,0,1,0.0,1,1,1,0,0,1,2,0
Rodri,Manchester City,2,1,1,1,0,0,0,,0,1,0,1,1,3,0,0
Mubama,Manchester City,0,0,0,0,0,0,0,,0,0,0,0,0,0,0,0
Bobb,Manchester City,0,0,0,0,0,0,0,,0,0,0,0,0,0,0,0
Reis,Manchester City,0,0,0,0,0,0,0,,0,0,0,0,0,0,1,0
Onana,Manchester United,1,1,1,0,0,1,3,33.3,2,0,0,0,0,1,11,4
Fernandes,Manchester United,77,47,25,37,15,30,78,38.5,48,33,5,28,25,102,35,2
Mazraoui,Manchester United,109,63,55,40,14,55,89,61.8,34,33,8,25,34,143,91,1
Dalot,Manchester United,67,39,39,22,6,34,52,65.4,18,22,9,13,37,104,72,0
Matthijs de Ligt,Manchester United,30,22,17,12,1,23,32,71.9,9,29,21,8,33,63,96,0
Garnacho,Manchester United,29,18,10,6,13,12,36,33.3,24,19,0,19,13,42,11,2
Manuel Ugarte Ribeiro,Manchester United,75,47,32,34,9,29,67,43.3,38,32,4,28,27,102,17,2
Højlund,Manchester United,3,1,0,2,1,0,4,0.0,4,5,0,5,1,4,6,0
Martínez,Manchester United,40,24,25,12,3,21,36,58.3,15,22,8,14,32,72,57,1
Mainoo,Manchester United,44,27,17,14,13,23,38,60.5,15,16,2,14,19,63,13,1
Diallo,Manchester United,36,29,7,20,9,18,30,60.0,12,12,0,12,11,47,17,0
Maguire,Manchester United,27,14,21,5,1,14,20,70.0,6,15,12,3,39,66,73,1
Casemiro,Manchester United,77,46,45,23,9,41,66,62.1,25,33,10,23,12,89,48,3
Zirkzee,Manchester United,14,8,3,8,3,5,10,50.0,5,15,4,11,6,20,8,1
Yoro,Manchester United,29,11,19,9,1,13,19,68.4,6,5,3,2,18,47,43,0
Rashford,Manchester United,7,4,2,2,3,3,9,33.3,6,8,0,8,4,11,7,0
Eriksen,Manchester United,19,9,4,12,3,11,26,42.3,15,14,4,10,7,26,7,0
Dorgu,Manchester United,25,19,12,11,2,14,19,73.7,5,10,0,10,4,29,19,2
Mount,Manchester United,12,4,5,7,0,8,10,80.0,2,9,1,8,3,15,3,0
Lindelöf,Manchester United,6,2,5,0,1,3,4,75.0,1,5,3,2,7,13,33,2
Amass,Manchester United,6,2,5,1,0,2,8,25.0,6,11,1,10,2,8,11,0
Evans,Manchester United,7,5,4,3,0,2,4,50.0,2,2,1,1,4,11,13,0
Bayındır,Manchester United,0,0,0,0,0,0,1,0.0,1,0,0,0,0,0,6,1
Shaw,Manchester United,4,3,2,2,0,2,2,100.0,0,5,1,4,2,6,7,0
Fredricson,Manchester United,5,3,3,2,0,1,2,50.0,1,2,0,2,1,6,11,0
Malacia,Manchester United,2,1,2,0,0,1,2,50.0,1,0,0,0,1,3,1,1
Obi-Martin,Manchester United,2,1,0,0,2,2,2,100.0,0,0,0,0,0,2,1,0
Heaven,Manchester United,3,3,1,2,0,2,2,100.0,0,2,2,0,1,4,6,0
Collyer,Manchester United,12,9,6,6,0,5,6,83.3,1,2,1,1,2,14,3,0
Antony,Manchester United,6,3,4,2,0,2,5,40.0,3,2,0,2,2,8,0,0
McTominay,Manchester United,0,0,0,0,0,0,1,0.0,1,0,0,0,0,0,1,0
Guimarães,Newcastle United,76,43,37,28,11,32,67,47.8,35,35,10,25,28,104,42,4
Burn,Newcastle United,35,20,20,13,2,17,33,51.5,16,34,24,10,26,61,184,3
Isak,Newcastle United,12,5,2,3,7,5,15,33.3,10,18,2,16,3,15,17,1
Schär,Newcastle United,34,21,15,17,2,14,34,41.2,20,37,24,13,41,75,125,3
Livramento,Newcastle United,54,36,35,15,4,32,59,54.2,27,35,10,25,21,75,103,1
Joelinton,Newcastle United,57,35,23,23,11,25,44,56.8,19,37,7,30,23,80,47,2
Murphy,Newcastle United,24,16,8,10,6,18,35,51.4,17,31,0,31,12,36,31,1
Tonali,Newcastle United,48,30,21,22,5,23,46,50.0,23,32,10,22,33,81,33,2
Pope,Newcastle United,0,0,0,0,0,0,0,,0,1,0,1,1,1,30,5
Gordon,Newcastle United,31,17,9,18,4,12,34,35.3,22,24,2,22,6,37,9,2
Hall,Newcastle United,58,41,28,22,8,40,74,54.1,34,33,18,15,18,76,75,3
Barnes,Newcastle United,16,9,4,6,6,3,11,27.3,8,7,1,6,6,22,14,1
Trippier,Newcastle United,37,20,18,13,6,21,35,60.0,14,11,3,8,12,49,49,0
Willock,Newcastle United,28,16,15,10,3,18,29,62.1,11,24,6,18,6,34,7,0
Dúbravka,Newcastle United,0,0,0,0,0,0,0,,0,0,0,0,0,0,3,0
Longstaff,Newcastle United,27,16,10,9,8,18,27,66.7,9,17,5,12,7,34,8,0
Kelly,Newcastle United,5,4,4,1,0,1,1,100.0,0,6,4,2,1,6,17,0
Botman,Newcastle United,8,6,4,4,0,4,6,66.7,2,4,3,1,5,13,19,0
Krafth,Newcastle United,4,2,2,1,1,2,3,66.7,1,5,4,1,2,6,14,0
Wilson,Newcastle United,2,2,0,1,1,0,2,0.0,2,2,0,2,1,3,1,0
Miley,Newcastle United,12,10,4,7,1,7,14,50.0,7,5,1,4,2,14,5,2
Almirón,Newcastle United,3,2,2,0,1,2,3,66.7,1,2,0,2,0,3,0,0
Osula,Newcastle United,1,0,0,0,1,0,2,0.0,2,0,0,0,4,5,2,0
Targett,Newcastle United,0,0,0,0,0,0,1,0.0,1,0,0,0,1,1,1,0
Sels,Nottingham Forest,1,1,1,0,0,1,1,100.0,0,0,0,0,0,1,25,1
Milenković,Nottingham Forest,44,27,31,11,2,22,28,78.6,6,40,24,16,25,69,196,1
Murillo,Nottingham Forest,53,36,38,12,3,27,46,58.7,19,67,44,23,32,85,236,3
Aina,Nottingham Forest,54,41,39,14,1,35,63,55.6,28,32,12,20,31,85,107,4
Wood,Nottingham Forest,5,4,1,2,2,2,9,22.2,7,12,7,5,5,10,27,1
Gibbs-White,Nottingham Forest,42,21,14,22,6,16,32,50.0,16,17,4,13,21,63,28,1
Anderson,Nottingham Forest,86,52,51,28,7,44,103,42.7,59,44,9,35,30,116,70,4
Elanga,Nottingham Forest,18,13,8,8,2,5,17,29.4,12,11,1,10,6,24,25,0
Williams,Nottingham Forest,79,48,57,16,6,45,75,60.0,30,40,9,31,25,104,129,2
Hudson-Odoi,Nottingham Forest,20,14,7,8,5,11,17,64.7,6,11,0,11,13,33,11,1
Domínguez,Nottingham Forest,78,40,35,32,11,30,67,44.8,37,37,11,26,29,107,49,1
Yates,Nottingham Forest,42,21,24,14,4,17,37,45.9,20,36,9,27,26,68,61,1
Moreno,Nottingham Forest,25,18,20,5,0,15,39,38.5,24,11,5,6,15,40,43,0
Morato,Nottingham Forest,21,13,18,2,1,13,21,61.9,8,12,4,8,10,31,77,2
Silva,Nottingham Forest,25,13,12,11,2,5,25,20.0,20,9,1,8,12,37,17,0
Sangaré,Nottingham Forest,24,13,6,15,3,6,14,42.9,8,8,3,5,4,28,7,1
Ward-Prowse,Nottingham Forest,4,1,1,3,0,2,2,100.0,0,3,2,1,5,9,8,0
Danilo,Nottingham Forest,6,3,5,1,0,2,4,50.0,2,2,1,1,3,9,3,0
Awoniyi,Nottingham Forest,6,3,0,3,3,4,5,80.0,1,1,0,1,0,6,7,0
Sosa,Nottingham Forest,5,3,3,0,2,1,5,20.0,4,9,0,9,4,9,5,0
Boly,Nottingham Forest,6,1,5,1,0,4,4,100.0,0,4,2,2,3,9,12,0
Toffolo,Nottingham Forest,5,3,3,1,1,3,4,75.0,1,2,2,0,2,7,12,0
Eric da Silva Moreira,Nottingham Forest,2,2,2,0,0,2,6,33.3,4,0,0,0,1,3,0,0
Walker-Peters,Southampton,44,29,22,15,7,16,35,45.7,19,27,15,12,19,63,90,1
Fernandes,Southampton,86,46,43,28,15,33,66,50.0,33,41,7,34,26,112,34,7
Harwood-Bellis,Southampton,27,19,13,11,3,19,35,54.3,16,62,40,22,30,57,137,6
Bednarek,Southampton,36,19,23,13,0,16,31,51.6,15,47,36,11,56,92,190,5
Ramsdale,Southampton,0,0,0,0,0,0,2,0.0,2,0,0,0,2,2,9,2
Downes,Southampton,46,24,21,20,5,15,35,42.9,20,24,6,18,31,77,46,4
Aribo,Southampton,47,33,17,24,6,17,35,48.6,18,26,10,16,20,67,32,3
Dibling,Southampton,34,20,13,18,3,16,26,61.5,10,19,5,14,8,42,16,1
Manning,Southampton,28,17,16,10,2,14,26,53.8,12,20,11,9,17,45,47,0
Ugochukwu,Southampton,49,24,15,30,4,18,35,51.4,17,27,10,17,14,63,21,1
Stephens,Southampton,32,19,23,9,0,15,27,55.6,12,20,13,7,11,43,49,2
Sugawara,Southampton,29,16,14,14,1,18,30,60.0,12,17,7,10,10,39,46,3
Sulemana,Southampton,17,15,6,4,7,8,13,61.5,5,12,3,9,6,23,9,0
Armstrong,Southampton,12,3,2,7,3,3,14,21.4,11,6,1,5,3,15,8,0
Archer,Southampton,11,7,6,3,2,2,9,22.2,7,5,1,4,2,13,10,0
Bree,Southampton,18,13,8,9,1,10,25,40.0,15,9,3,6,8,26,28,0
Onuachu,Southampton,7,2,1,5,1,3,7,42.9,4,7,2,5,1,8,16,1
Wood-Gordon,Southampton,10,7,6,3,1,5,8,62.5,3,8,5,3,4,14,26,2
Smallbone,Southampton,18,11,8,8,2,7,21,33.3,14,8,0,8,2,20,12,2
McCarthy,Southampton,0,0,0,0,0,0,0,,0,0,0,0,0,0,1,4
Lallana,Southampton,8,5,4,4,0,2,12,16.7,10,4,1,3,5,13,5,0
Brereton,Southampton,3,2,0,2,1,1,9,11.1,8,2,1,1,0,3,4,0
Fraser,Southampton,6,2,2,4,0,4,6,66.7,2,1,1,0,1,7,9,0
Welington,Southampton,16,5,12,3,1,10,15,66.7,5,3,1,2,6,22,21,0
Stewart,Southampton,3,2,1,0,2,2,6,33.3,4,3,0,3,0,3,6,0
Lumley,Southampton,0,0,0,0,0,0,0,,0,0,0,0,0,0,3,3
Armel Bella Kotchap,Southampton,7,5,5,2,0,3,6,50.0,3,2,2,0,5,12,21,1
Taylor,Southampton,7,5,4,3,0,5,6,83.3,1,5,3,2,3,10,22,1
Grønbaek,Southampton,4,1,1,1,2,3,10,30.0,7,1,1,0,0,4,1,0
Cornet,Southampton,5,5,1,4,0,0,4,0.0,4,0,0,0,0,5,2,0
Edozie,Southampton,3,1,0,1,2,2,2,100.0,0,0,0,0,0,3,0,0
Robinson,Southampton,2,1,2,0,0,0,0,,0,0,0,0,0,2,0,0
Amo-Ameyaw,Southampton,1,0,0,1,0,1,1,100.0,0,0,0,0,0,1,0,0
Edwards,Southampton,0,0,0,0,0,0,0,,0,1,1,0,0,0,0,0
Alcaraz,Southampton,0,0,0,0,0,0,0,,0,0,0,0,1,1,0,0
Porro,Tottenham,63,46,31,22,10,42,73,57.5,31,44,17,27,34,97,82,1
Kulusevski,Tottenham,45,23,17,13,15,19,51,37.3,32,34,5,29,13,58,10,1
Solanke,Tottenham,18,11,1,12,5,4,14,28.6,10,18,7,11,0,18,22,0
Johnson,Tottenham,39,26,9,20,10,16,31,51.6,15,25,3,22,4,43,11,0
Vicario,Tottenham,0,0,0,0,0,0,0,,0,0,0,0,1,1,14,6
Heung-min,Tottenham,17,9,3,8,6,5,23,21.7,18,10,0,10,5,22,16,1
Udogie,Tottenham,74,47,41,26,7,33,47,70.2,14,40,6,34,21,95,35,1
Maddison,Tottenham,31,19,8,16,7,9,29,31.0,20,15,4,11,12,43,19,1
Pape Matar Sarr,Tottenham,47,35,18,23,6,12,24,50.0,12,24,10,14,27,74,22,1
Bentancur,Tottenham,38,20,17,17,4,19,39,48.7,20,25,8,17,36,74,35,1
Spence,Tottenham,45,33,24,14,7,23,30,76.7,7,27,9,18,20,65,68,1
Romero,Tottenham,35,29,26,8,1,21,30,70.0,9,18,3,15,21,56,57,2
Gray,Tottenham,15,8,4,7,4,7,17,41.2,10,20,10,10,15,30,42,2
Bissouma,Tottenham,48,30,19,25,4,19,34,55.9,15,9,6,3,17,65,37,4
Drăgușin,Tottenham,10,6,8,2,0,6,12,50.0,6,22,16,6,15,25,49,4
Davies,Tottenham,16,11,7,8,1,9,16,56.3,7,26,18,8,12,28,72,1
Bergvall,Tottenham,39,19,14,20,5,17,32,53.1,15,18,8,10,24,63,22,3
Micky van de Ven,Tottenham,10,6,5,4,1,8,14,57.1,6,9,6,3,10,20,36,1
Tel,Tottenham,12,5,2,5,5,2,9,22.2,7,8,1,7,1,13,4,2
Odobert,Tottenham,12,4,4,3,5,7,12,58.3,5,5,0,5,3,15,3,1
Danso,Tottenham,7,5,4,3,0,6,10,60.0,4,9,9,0,3,10,49,1
Forster,Tottenham,0,0,0,0,0,0,1,0.0,1,0,0,0,0,0,7,3
Kinský,Tottenham,3,1,3,0,0,1,1,100.0,0,0,0,0,0,3,7,1
Werner,Tottenham,6,4,3,3,0,3,13,23.1,10,10,1,9,1,7,7,0
Richarlison,Tottenham,4,3,0,3,1,0,2,0.0,2,1,1,0,0,4,8,0
Moore,Tottenham,0,0,0,0,0,0,2,0.0,2,2,0,2,1,1,3,0
Austin,Tottenham,0,0,0,0,0,0,0,,0,0,0,0,0,0,1,0
Reguilón,Tottenham,4,3,1,3,0,2,3,66.7,1,4,0,4,2,6,3,0
Scarlett,Tottenham,1,0,0,1,0,0,0,,0,0,0,0,0,1,1,0
Dorrington,Tottenham,0,0,0,0,0,0,0,,0,0,0,0,0,0,0,0
Lankshear,Tottenham,0,0,0,0,0,0,0,,0,0,0,0,0,0,0,0
Kilman,West Ham,36,22,15,18,3,22,26,84.6,4,56,38,18,38,74,202,5
Wan-Bissaka,West Ham,67,47,32,30,5,23,31,74.2,8,34,9,25,61,128,119,0
Bowen,West Ham,38,25,13,11,14,17,37,45.9,20,21,3,18,16,54,23,0
Kudus,West Ham,35,21,7,17,11,10,27,37.0,17,24,1,23,4,39,8,2
Souček,West Ham,43,20,20,20,3,23,40,57.5,17,38,20,18,19,62,79,1
Paquetá,West Ham,66,37,25,30,11,27,54,50.0,27,28,4,24,17,83,37,6
Palmieri,West Ham,60,31,37,18,5,27,48,56.3,21,32,8,24,21,81,59,0
Areola,West Ham,2,2,2,0,0,2,3,66.7,1,0,0,0,0,2,15,2
Mavropanos,West Ham,33,22,22,10,1,15,26,57.7,11,24,17,7,39,72,118,1
Álvarez,West Ham,44,23,24,12,8,15,33,45.5,18,21,8,13,17,61,39,1
Todibo,West Ham,41,24,26,14,1,25,34,73.5,9,24,12,12,23,64,72,3
Rodríguez,West Ham,32,17,20,12,0,16,32,50.0,16,22,9,13,12,44,30,1
Soler,West Ham,15,11,8,6,1,7,23,30.4,16,19,6,13,8,23,21,2
Fabiański,West Ham,0,0,0,0,0,0,1,0.0,1,0,0,0,0,0,5,1
Antonio,West Ham,2,2,0,1,1,2,3,66.7,1,6,0,6,0,2,2,0
Coufal,West Ham,19,12,12,5,2,8,19,42.1,11,13,11,2,8,27,38,1
Ward-Prowse,West Ham,18,13,8,6,4,6,15,40.0,9,6,3,3,6,24,13,0
Cresswell,West Ham,11,7,5,5,1,9,11,81.8,2,9,4,5,8,19,36,0
Summerville,West Ham,13,7,2,8,3,3,9,33.3,6,13,4,9,0,13,7,0
Scarles,West Ham,17,11,13,3,1,13,21,61.9,8,14,2,12,10,27,24,0
Füllkrug,West Ham,3,2,0,1,2,3,4,75.0,1,1,0,1,1,4,12,0
Ings,West Ham,4,2,2,2,0,1,3,33.3,2,5,0,5,1,5,4,0
Irving,West Ham,7,4,3,3,1,1,5,20.0,4,5,1,4,1,8,5,0
Ferguson,West Ham,3,1,0,1,2,0,0,,0,2,1,1,1,4,1,0
Guilherme,West Ham,1,0,1,0,0,0,3,0.0,3,7,0,7,3,4,2,0
Orford,West Ham,0,0,0,0,0,0,0,,0,1,0,1,1,1,0,0
Casey,West Ham,0,0,0,0,0,0,0,,0,0,0,0,0,0,1,0
Aït-Nouri,Wolves,85,55,51,26,8,41,68,60.3,27,41,6,35,25,110,70,1
Gomes,Wolves,105,62,53,48,4,42,103,40.8,61,42,4,38,25,130,32,0
Semedo,Wolves,59,34,31,21,7,31,54,57.4,23,29,10,19,23,82,101,3
Jørgen Strand Larsen,Wolves,9,6,2,3,4,4,27,14.8,23,18,4,14,6,15,28,0
André,Wolves,88,53,40,40,8,35,61,57.4,26,42,8,34,35,123,30,1
Sá,Wolves,2,2,2,0,0,2,2,100.0,0,0,0,0,0,2,15,1
Cunha,Wolves,35,21,16,15,4,11,36,30.6,25,21,1,20,17,52,23,0
Gomes,Wolves,57,41,40,14,3,33,42,78.6,9,28,17,11,24,81,142,5
Doherty,Wolves,37,20,25,12,0,16,24,66.7,8,27,15,12,22,59,95,3
Bellegarde,Wolves,37,22,17,17,3,13,19,68.4,6,19,3,16,10,47,18,1
Bueno,Wolves,40,21,21,18,1,17,22,77.3,5,35,20,15,15,55,70,0
Lemina,Wolves,51,31,27,19,5,20,29,69.0,9,12,7,5,27,78,50,3
Agbadou,Wolves,27,18,18,9,0,11,17,64.7,6,19,13,6,11,38,82,0
Munetsi,Wolves,22,10,6,10,6,12,21,57.1,9,13,1,12,6,28,16,0
Dawson,Wolves,15,3,8,6,1,12,15,80.0,3,16,11,5,9,24,52,1
Guedes,Wolves,14,4,2,5,7,3,15,20.0,12,9,0,9,5,19,3,0
Johnstone,Wolves,0,0,0,0,0,0,1,0.0,1,0,0,0,0,0,7,0
Sarabia,Wolves,15,8,4,8,3,9,15,60.0,6,10,0,10,4,19,7,1
Gomes,Wolves,21,13,12,9,0,10,19,52.6,9,8,1,7,5,26,20,1
Hee-chan,Wolves,6,4,2,1,3,2,6,33.3,4,9,0,9,2,8,11,0
Mosquera,Wolves,11,7,9,2,0,9,14,64.3,5,13,10,3,10,21,14,0
Doyle,Wolves,11,6,6,3,2,6,15,40.0,9,11,5,6,5,16,11,1
Forbs,Wolves,8,5,5,2,1,4,6,66.7,2,3,0,3,1,9,2,1
Bentley,Wolves,0,0,0,0,0,0,0,,0,0,0,0,0,0,0,0
Lima,Wolves,1,0,0,0,1,1,3,33.3,2,0,0,0,2,3,5,0
Podence,Wolves,0,0,0,0,0,0,1,0.0,1,0,0,0,0,0,0,0
Djiga,Wolves,0,0,0,0,0,0,0,,0,0,0,0,2,2,3,1
Chiquinho,Wolves,0,0,0,0,0,0,0,,0,0,0,0,0,0,0,0
Mane,Wolves,0,0,0,0,0,0,0,,0,1,0,1,0,0,0,0
Pond,Wolves,0,0,0,0,0,0,0,,0,0,0,0,0,0,0,0
Traoré,Wolves,2,0,0,2,0,1,1,100.0,0,0,0,0,0,2,0,0
